FIPS,State,County,Total_law,"Total
officers","Total
civilians"
1001,AL,Autauga,74,37,37
1003,AL,Baldwin,288,115,173
1007,AL,Bibb,12,11,1
1015,AL,Calhoun,55,50,5
1021,AL,Chilton,32,28,4
1051,AL,Elmore,108,48,60
1055,AL,Etowah,156,61,95
1061,AL,Geneva,27,13,14
1065,AL,Hale,27,11,16
1067,AL,Henry,20,16,4
1069,AL,Houston,152,62,90
1077,AL,Lauderdale,42,36,6
1081,AL,Lee,176,79,97
1083,AL,Limestone,117,47,70
1085,AL,Lowndes,37,17,20
1097,AL,Mobile,541,188,353
1101,AL,Montgomery,169,129,40
1107,AL,Pickens,33,9,24
1113,AL,Russell,128,40,88
1115,AL,St. Clair,56,48,8
1125,AL,Tuscaloosa,204,101,103
1127,AL,Walker,83,34,49
1011,AL,Bullock,13,6,7
1027,AL,Clay,26,10,16
1029,AL,Cleburne,27,10,17
1035,AL,Conecuh,39,13,26
1037,AL,Coosa,25,11,14
1039,AL,Covington,28,25,3
1045,AL,Dale,49,25,24
1047,AL,Dallas,50,23,27
1053,AL,Escambia,66,27,39
1063,AL,Greene,32,14,18
1075,AL,Lamar,18,7,11
1087,AL,Macon,35,12,23
1093,AL,Marion,31,15,16
1095,AL,Marshall,73,39,34
1109,AL,Pike,28,17,11
1121,AL,Talladega,101,38,63
1123,AL,Tallapoosa,57,25,32
1133,AL,Winston,28,10,18
4003,AZ,Cochise,116,81,35
4005,AZ,Coconino,239,56,183
4013,AZ,Maricopa,3397,706,"2,691"
4015,AZ,Mohave,250,80,170
4019,AZ,Pima,1465,512,953
4021,AZ,Pinal,352,155,197
4025,AZ,Yavapai,171,110,61
4027,AZ,Yuma,310,72,238
4001,AZ,Apache,70,31,39
4007,AZ,Gila,190,44,146
4009,AZ,Graham,76,23,53
4011,AZ,Greenlee,42,12,30
4012,AZ,La Paz,85,30,55
4017,AZ,Navajo,141,56,85
4023,AZ,Santa Cruz,87,35,52
5007,AR,Benton,218,135,83
5025,AR,Cleveland,12,7,5
5031,AR,Craighead,121,45,76
5033,AR,Crawford,70,33,37
5035,AR,Crittenden,143,40,103
5045,AR,Faulkner,164,47,117
5051,AR,Garland,184,56,128
5053,AR,Grant,17,14,3
5069,AR,Jefferson,115,43,72
5079,AR,Lincoln,21,9,12
5081,AR,Little River,29,12,17
5085,AR,Lonoke,67,31,36
5087,AR,Madison,19,9,10
5091,AR,Miller,68,24,44
5105,AR,Perry,21,11,10
5111,AR,Poinsett,37,10,27
5119,AR,Pulaski,516,125,391
5125,AR,Saline,93,48,45
5131,AR,Sebastian,161,41,120
5143,AR,Washington,274,150,124
5001,AR,Arkansas,50,11,39
5003,AR,Ashley,36,17,19
5005,AR,Baxter,52,32,20
5009,AR,Boone,52,25,27
5011,AR,Bradley,7,5,2
5013,AR,Calhoun,12,6,6
5015,AR,Carroll,23,20,3
5017,AR,Chicot,11,7,4
5019,AR,Clark,27,13,14
5021,AR,Clay,26,10,16
5023,AR,Cleburne,42,23,19
5027,AR,Columbia,39,22,17
5029,AR,Conway,41,18,23
5037,AR,Cross,42,18,24
5039,AR,Dallas,25,6,19
5041,AR,Desha,7,6,1
5043,AR,Drew,10,9,1
5047,AR,Franklin,24,11,13
5049,AR,Fulton,13,5,8
5055,AR,Greene,30,22,8
5057,AR,Hempstead,48,18,30
5061,AR,Howard,24,11,13
5063,AR,Independence,58,32,26
5065,AR,Izard,35,19,16
5067,AR,Jackson,38,15,23
5071,AR,Johnson,45,16,29
5073,AR,Lafayette,24,19,5
5075,AR,Lawrence,24,11,13
5077,AR,Lee,10,5,5
5083,AR,Logan,30,13,17
5089,AR,Marion,17,15,2
5093,AR,Mississippi,94,39,55
5095,AR,Monroe,16,6,10
5097,AR,Montgomery,19,11,8
5099,AR,Nevada,29,22,7
5101,AR,Newton,17,7,10
5103,AR,Ouachita,44,17,27
5109,AR,Pike,22,8,14
5113,AR,Polk,27,14,13
5115,AR,Pope,83,33,50
5117,AR,Prairie,21,7,14
5121,AR,Randolph,11,10,1
5127,AR,Scott,27,8,19
5129,AR,Searcy,14,7,7
5133,AR,Sevier,34,16,18
5135,AR,Sharp,32,14,18
5123,AR,St. Francis,37,17,20
5137,AR,Stone,22,11,11
5139,AR,Union,63,36,27
5141,AR,Van Buren,38,20,18
5145,AR,White,96,52,44
5147,AR,Woodruff,14,5,9
6001,CA,Alameda,1564,"1,003",561
6007,CA,Butte,269,94,175
6013,CA,Contra Costa,957,633,324
6017,CA,El Dorado,349,154,195
6019,CA,Fresno,1104,406,698
6025,CA,Imperial,286,190,96
6029,CA,Kern,1137,826,311
6031,CA,Kings,271,75,196
6037,CA,Los Angeles,16721,"9,316","7,405"
6039,CA,Madera,107,79,28
6041,CA,Marin,291,191,100
6047,CA,Merced,223,88,135
6053,CA,Monterey,416,295,121
6055,CA,Napa,139,100,39
6059,CA,Orange,3622,"1,745","1,877"
6061,CA,Placer,513,244,269
6065,CA,Riverside,3939,"2,003","1,936"
6067,CA,Sacramento,1923,"1,247",676
6069,CA,San Benito,54,26,28
6071,CA,San Bernardino,3059,"1,855","1,204"
6073,CA,San Diego,4254,"2,569","1,685"
6075,CA,San Francisco,1027,830,197
6077,CA,San Joaquin,699,274,425
6079,CA,San Luis Obispo,396,295,101
6081,CA,San Mateo,681,330,351
6083,CA,Santa Barbara,617,452,165
6085,CA,Santa Clara,1655,"1,257",398
6087,CA,Santa Cruz,332,142,190
6089,CA,Shasta,216,153,63
6095,CA,Solano,526,124,402
6097,CA,Sonoma,331,232,99
6099,CA,Stanislaus,611,456,155
6101,CA,Sutter,133,105,28
6107,CA,Tulare,747,531,216
6111,CA,Ventura,1247,756,491
6113,CA,Yolo,263,89,174
6115,CA,Yuba,162,118,44
6003,CA,Alpine,17,13,4
6005,CA,Amador,86,45,41
6009,CA,Calaveras,101,49,52
6011,CA,Colusa,65,33,32
6015,CA,Del Norte,55,24,31
6021,CA,Glenn,55,22,33
6023,CA,Humboldt,235,182,53
6027,CA,Inyo,71,35,36
6033,CA,Lake,135,53,82
6035,CA,Lassen,81,59,22
6043,CA,Mariposa,71,56,15
6045,CA,Mendocino,165,123,42
6049,CA,Modoc,28,19,9
6051,CA,Mono,38,21,17
6057,CA,Nevada,155,63,92
6063,CA,Plumas,65,33,32
6091,CA,Sierra,17,11,6
6093,CA,Siskiyou,108,86,22
6103,CA,Tehama,113,79,34
6105,CA,Trinity,44,35,9
6109,CA,Tuolumne,126,62,64
8001,CO,Adams,540,355,185
8005,CO,Arapahoe,515,226,289
8013,CO,Boulder,373,211,162
8019,CO,Clear Creek,73,29,44
8035,CO,Douglas,470,309,161
8039,CO,Elbert,44,37,7
8041,CO,El Paso,795,506,289
8047,CO,Gilpin,57,40,17
8059,CO,Jefferson,811,531,280
8069,CO,Larimer,365,245,120
8077,CO,Mesa,206,98,108
8093,CO,Park,56,31,25
8101,CO,Pueblo,347,92,255
8119,CO,Teller,70,45,25
8123,CO,Weld,351,144,207
8003,CO,Alamosa,44,27,17
8007,CO,Archuleta,33,14,19
8009,CO,Baca,12,4,8
8011,CO,Bent,27,13,14
8015,CO,Chaffee,54,20,34
8017,CO,Cheyenne,9,5,4
8021,CO,Conejos,30,10,20
8023,CO,Costilla,9,6,3
8025,CO,Crowley,13,6,7
8027,CO,Custer,23,10,13
8029,CO,Delta,65,34,31
8033,CO,Dolores,8,5,3
8037,CO,Eagle,74,42,32
8043,CO,Fremont,115,52,63
8045,CO,Garfield,136,53,83
8049,CO,Grand,51,24,27
8051,CO,Gunnison,31,13,18
8053,CO,Hinsdale,5,4,1
8055,CO,Huerfano,23,10,13
8057,CO,Jackson,7,3,4
8061,CO,Kiowa,6,5,1
8063,CO,Kit Carson,31,7,24
8065,CO,Lake,27,12,15
8067,CO,La Plata,129,103,26
8071,CO,Las Animas,31,13,18
8073,CO,Lincoln,22,21,1
8075,CO,Logan,52,19,33
8079,CO,Mineral,6,4,2
8081,CO,Moffat,37,34,3
8083,CO,Montezuma,70,29,41
8085,CO,Montrose,98,44,54
8087,CO,Morgan,51,17,34
8089,CO,Otero,23,20,3
8091,CO,Ouray,7,7,0
8095,CO,Phillips,4,4,0
8097,CO,Pitkin,58,23,35
8099,CO,Prowers,30,10,20
8103,CO,Rio Blanco,27,11,16
8105,CO,Rio Grande,34,14,20
8107,CO,Routt,49,40,9
8109,CO,Saguache,19,8,11
8111,CO,San Juan,3,3,0
8113,CO,San Miguel,36,16,20
8115,CO,Sedgwick,7,6,1
8117,CO,Summit,59,50,9
8121,CO,Washington,45,9,36
8125,CO,Yuma,24,9,15
10003,DE,New Castle ,483,367,116
12003,FL,Baker,145,39,106
12005,FL,Bay,273,207,66
12015,FL,Charlotte,406,294,112
12017,FL,Citrus,419,220,199
12019,FL,Clay,545,268,277
12021,FL,Collier,884,567,317
12033,FL,Escambia,665,411,254
12035,FL,Flagler,250,189,61
12039,FL,Gadsden,68,42,26
12041,FL,Gilchrist,49,27,22
12045,FL,Gulf,40,27,13
12055,FL,Highlands,323,137,186
12057,FL,Hillsborough,3273,"1,181","2,092"
12061,FL,Indian River,456,180,276
12065,FL,Jefferson,62,25,37
12071,FL,Lee,1527,702,825
12073,FL,Leon,378,253,125
12081,FL,Manatee,1109,724,385
12083,FL,Marion,718,502,216
12085,FL,Martin,495,276,219
12089,FL,Nassau,239,158,81
12095,FL,Orange,2097,"1,447",650
12097,FL,Osceola,610,395,215
12099,FL,Palm Beach,3397,"1,533","1,864"
12113,FL,Santa Rosa,379,194,185
12115,FL,Sarasota,942,406,536
12117,FL,Seminole,1148,572,576
12109,FL,St. Johns,608,277,331
12119,FL,Sumter,287,211,76
12127,FL,Volusia,719,422,297
12129,FL,Wakulla,111,69,42
12131,FL,Walton,374,250,124
12007,FL,Bradford,54,36,18
12013,FL,Calhoun,30,21,9
12027,FL,DeSoto,123,60,63
12029,FL,Dixie,73,26,47
12043,FL,Glades,100,29,71
12049,FL,Hardee,100,72,28
12059,FL,Holmes,52,25,27
12063,FL,Jackson,79,59,20
12075,FL,Levy,152,79,73
12077,FL,Liberty,40,17,23
12079,FL,Madison,78,41,37
12087,FL,Monroe,501,195,306
12093,FL,Okeechobee,171,125,46
12107,FL,Putnam,204,101,103
12121,FL,Suwannee,111,61,50
12123,FL,Taylor,75,32,43
12125,FL,Union,20,14,6
12133,FL,Washington,60,37,23
13013,GA,Barrow,165,116,49
13015,GA,Bartow,206,193,13
13021,GA,Bibb,540,454,86
13025,GA,Brantley,47,19,28
13027,GA,Brooks,38,22,16
13035,GA,Butts,89,52,37
13045,GA,Carroll,191,107,84
13057,GA,Cherokee,379,335,44
13059,GA,Clarke,165,134,31
13063,GA,Clayton,460,163,297
13067,GA,Cobb ,708,649,59
13073,GA,Columbia,344,242,102
13077,GA,Coweta,237,160,77
13079,GA,Crawford,32,14,18
13085,GA,Dawson,92,58,34
13089,GA,DeKalb,766,564,202
13095,GA,Dougherty,235,226,9
13097,GA,Douglas,335,295,40
13101,GA,Echols,9,7,2
13103,GA,Effingham,139,76,63
13113,GA,Fayette,216,143,73
13115,GA,Floyd,77,72,5
13117,GA,Forsyth,406,332,74
13121,GA,Fulton,931,737,194
13127,GA,Glynn ,124,116,8
13135,GA,Gwinnett ,939,667,272
13139,GA,Hall,411,263,148
13143,GA,Haralson,79,71,8
13145,GA,Harris,73,71,2
13149,GA,Heard,36,19,17
13151,GA,Henry ,244,208,36
13169,GA,Jones,73,53,20
13195,GA,Madison,65,43,22
13197,GA,Marion,14,5,9
13191,GA,McIntosh,63,39,24
13199,GA,Meriwether,53,29,24
13219,GA,Oconee,88,55,33
13223,GA,Paulding,273,238,35
13225,GA,Peach,57,32,25
13255,GA,Spalding,168,136,32
13273,GA,Terrell,32,30,2
13295,GA,Walker,101,63,38
13297,GA,Walton,190,172,18
13321,GA,Worth,33,29,4
13009,GA,Baldwin,124,58,66
13011,GA,Banks,60,57,3
13017,GA,Ben Hill,53,48,5
13031,GA,Bulloch,111,101,10
13039,GA,Camden,125,66,59
13061,GA,Clay,6,5,1
13065,GA,Clinch,16,11,5
13069,GA,Coffee,105,51,54
13075,GA,Cook,47,40,7
13087,GA,Decatur,60,48,12
13091,GA,Dodge,56,20,36
13093,GA,Dooly,75,33,42
13099,GA,Early,46,25,21
13105,GA,Elbert,55,29,26
13107,GA,Emanuel,40,33,7
13109,GA,Evans,16,9,7
13111,GA,Fannin,49,46,3
13123,GA,Gilmer,98,76,22
13129,GA,Gordon,137,80,57
13131,GA,Grady,42,18,24
13141,GA,Hancock,40,25,15
13147,GA,Hart,51,31,20
13155,GA,Irwin,21,13,8
13157,GA,Jackson,165,97,68
13161,GA,Jeff Davis,41,26,15
13163,GA,Jefferson,44,41,3
13167,GA,Johnson,17,9,8
13175,GA,Laurens,105,87,18
13229,GA,Pierce,49,18,31
13233,GA,Polk,75,37,38
13237,GA,Putnam,64,32,32
13239,GA,Quitman,7,5,2
13241,GA,Rabun,53,51,2
13249,GA,Schley,8,4,4
13251,GA,Screven,20,19,1
13253,GA,Seminole,31,16,15
13257,GA,Stephens,64,38,26
13263,GA,Talbot,17,11,6
13269,GA,Taylor,21,20,1
13275,GA,Thomas,84,80,4
13277,GA,Tift,107,91,16
13283,GA,Treutlen,22,12,10
13285,GA,Troup,80,73,7
13287,GA,Turner,41,21,20
13291,GA,Union,54,49,5
13293,GA,Upson,68,35,33
13299,GA,Ware,144,39,105
13301,GA,Warren,8,8,0
13303,GA,Washington,51,46,5
13305,GA,Wayne,69,32,37
13307,GA,Webster,5,5,0
13309,GA,Wheeler,12,7,5
13317,GA,Wilkes,40,25,15
13319,GA,Wilkinson,30,18,12
15009,HI,Maui,486,372,114
15001,HI,Hawaii,559,431,128
15007,HI,Kauai,197,150,47
16001,ID,Ada,438,140,298
16005,ID,Bannock,66,42,24
16015,ID,Boise,23,13,10
16019,ID,Bonneville,102,67,35
16023,ID,Butte,11,4,7
16027,ID,Canyon,159,69,90
16041,ID,Franklin,15,10,5
16045,ID,Gem,22,13,9
16051,ID,Jefferson,33,19,14
16055,ID,Kootenai,167,93,74
16069,ID,Nez Perce,45,22,23
16073,ID,Owyhee,20,12,8
16003,ID,Adams,13,6,7
16007,ID,Bear Lake,13,6,7
16009,ID,Benewah,15,7,8
16011,ID,Bingham,53,34,19
16013,ID,Blaine,42,36,6
16017,ID,Bonner,71,40,31
16021,ID,Boundary,19,8,11
16025,ID,Camas,6,4,2
16029,ID,Caribou,17,9,8
16031,ID,Cassia,52,32,20
16033,ID,Clark,7,3,4
16035,ID,Clearwater,18,11,7
16037,ID,Custer,15,8,7
16039,ID,Elmore,42,21,21
16043,ID,Fremont,28,20,8
16047,ID,Gooding,21,16,5
16049,ID,Idaho,30,20,10
16053,ID,Jerome,22,17,5
16057,ID,Latah,36,25,11
16059,ID,Lemhi,10,8,2
16061,ID,Lewis,8,5,3
16063,ID,Lincoln,8,7,1
16065,ID,Madison,35,21,14
16067,ID,Minidoka,29,19,10
16071,ID,Oneida,14,8,6
16075,ID,Payette,32,16,16
16077,ID,Power,17,9,8
16079,ID,Shoshone,26,17,9
16081,ID,Teton,19,11,8
16083,ID,Twin Falls,69,42,27
16085,ID,Valley,26,16,10
16087,ID,Washington,21,13,8
17031,IL,Cook,6106,"1,800","4,306"
17053,IL,Ford,25,23,2
17063,IL,Grundy,49,31,18
17073,IL,Henry,63,22,41
17077,IL,Jackson,87,28,59
17089,IL,Kane,268,76,192
17091,IL,Kankakee,172,46,126
17093,IL,Kendall,108,52,56
17117,IL,Macoupin,43,20,23
17119,IL,Madison,161,81,80
17123,IL,Marshall,24,8,16
17111,IL,McHenry,345,88,257
17113,IL,McLean,134,50,84
17133,IL,Monroe,34,16,18
17167,IL,Sangamon,199,64,135
17199,IL,Williamson,82,27,55
17009,IL,Brown,7,7,0
17025,IL,Clay,16,10,6
17035,IL,Cumberland,14,5,9
17041,IL,Douglas,20,10,10
17049,IL,Effingham,46,19,27
17057,IL,Fulton,39,20,19
17067,IL,Hancock,19,8,11
17075,IL,Iroquois,24,13,11
17081,IL,Jefferson,53,19,34
17085,IL,Jo Daviess,37,18,19
17105,IL,Livingston,69,28,41
17107,IL,Logan,27,19,8
17109,IL,McDonough,25,13,12
17137,IL,Morgan,32,14,18
17141,IL,Ogle,77,28,49
17145,IL,Perry,32,12,20
17155,IL,Putnam,13,8,5
17165,IL,Saline,46,12,34
17171,IL,Scott,5,2,3
17195,IL,Whiteside,48,20,28
18003,IN,Allen,299,127,172
18013,IN,Brown,40,14,26
18019,IN,Clark,151,41,110
18043,IN,Floyd,112,32,80
18059,IN,Hancock,73,39,34
18067,IN,Howard,133,34,99
18111,IN,Newton,38,16,22
18145,IN,Shelby,93,32,61
18167,IN,Vigo,42,39,3
18173,IN,Warrick,78,39,39
18179,IN,Wells,16,16,0
18009,IN,Blackford,30,9,21
18049,IN,Fulton,27,12,15
18051,IN,Gibson,41,16,25
18055,IN,Greene,45,18,27
18075,IN,Jay,41,13,28
18151,IN,Steuben,54,21,33
18159,IN,Tipton,33,13,20
18169,IN,Wabash,42,16,26
19011,IA,Benton,31,12,19
19013,IA,Black Hawk,137,95,42
19017,IA,Bremer,32,12,20
19049,IA,Dallas,58,24,34
19061,IA,Dubuque,87,72,15
19075,IA,Grundy,16,12,4
19077,IA,Guthrie,14,9,5
19085,IA,Harrison,11,10,1
19103,IA,Johnson,90,68,22
19105,IA,Jones,24,10,14
19113,IA,Linn,188,121,67
19121,IA,Madison,16,8,8
19129,IA,Mills,27,11,16
19149,IA,Plymouth,31,11,20
19153,IA,Polk,459,127,332
19155,IA,Pottawattamie,200,54,146
19163,IA,Scott,153,43,110
19169,IA,Story,85,31,54
19181,IA,Warren,36,20,16
19183,IA,Washington,36,17,19
19193,IA,Woodbury,129,38,91
19001,IA,Adair,13,5,8
19003,IA,Adams,11,6,5
19005,IA,Allamakee,17,9,8
19007,IA,Appanoose,15,7,8
19009,IA,Audubon,10,6,4
19015,IA,Boone,29,11,18
19019,IA,Buchanan,28,13,15
19021,IA,Buena Vista,34,13,21
19023,IA,Butler,18,12,6
19025,IA,Calhoun,11,6,5
19027,IA,Carroll,22,9,13
19029,IA,Cass,12,9,3
19031,IA,Cedar,36,13,23
19033,IA,Cerro Gordo,73,20,53
19035,IA,Cherokee,20,7,13
19037,IA,Chickasaw,15,8,7
19039,IA,Clarke,20,7,13
19041,IA,Clay,23,10,13
19043,IA,Clayton,26,12,14
19045,IA,Clinton,43,25,18
19047,IA,Crawford,15,10,5
19051,IA,Davis,6,5,1
19053,IA,Decatur,17,6,11
19055,IA,Delaware,20,13,7
19057,IA,Des Moines,47,20,27
19059,IA,Dickinson,19,9,10
19063,IA,Emmet,18,9,9
19065,IA,Fayette,37,12,25
19067,IA,Floyd,18,11,7
19069,IA,Franklin,10,7,3
19071,IA,Fremont,26,9,17
19073,IA,Greene,16,7,9
19079,IA,Hamilton,26,10,16
19081,IA,Hancock,11,11,0
19083,IA,Hardin,31,11,20
19087,IA,Henry,30,11,19
19089,IA,Howard,16,9,7
19091,IA,Humboldt,15,9,6
19093,IA,Ida,17,10,7
19095,IA,Iowa,28,12,16
19097,IA,Jackson,17,10,7
19099,IA,Jasper,46,17,29
19101,IA,Jefferson,29,27,2
19107,IA,Keokuk,11,6,5
19109,IA,Kossuth,25,10,15
19111,IA,Lee,35,15,20
19115,IA,Louisa,28,11,17
19117,IA,Lucas,12,5,7
19119,IA,Lyon,26,12,14
19123,IA,Mahaska,23,9,14
19125,IA,Marion,36,15,21
19127,IA,Marshall,55,19,36
19131,IA,Mitchell,16,7,9
19133,IA,Monona,18,8,10
19135,IA,Monroe,14,5,9
19137,IA,Montgomery,19,8,11
19139,IA,Muscatine,70,21,49
19141,IA,O'Brien,28,9,19
19143,IA,Osceola,13,9,4
19145,IA,Page,16,8,8
19147,IA,Palo Alto,17,8,9
19151,IA,Pocahontas,15,7,8
19159,IA,Ringgold,12,6,6
19161,IA,Sac,19,8,11
19165,IA,Shelby,15,9,6
19167,IA,Sioux,40,14,26
19171,IA,Tama,22,13,9
19173,IA,Taylor,13,9,4
19175,IA,Union,12,6,6
19177,IA,Van Buren,11,5,6
19179,IA,Wapello,44,12,32
19185,IA,Wayne,15,6,9
19187,IA,Webster,32,16,16
19191,IA,Winneshiek,23,10,13
19195,IA,Worth,25,13,12
19197,IA,Wright,20,9,11
20015,KS,Butler,98,65,33
20045,KS,Douglas,148,76,72
20079,KS,Harvey,21,19,2
20085,KS,Jackson,30,22,8
20087,KS,Jefferson,37,23,14
20091,KS,Johnson,598,448,150
20095,KS,Kingman,21,8,13
20103,KS,Leavenworth,85,64,21
20107,KS,Linn,29,19,10
20121,KS,Miami,48,26,22
20139,KS,Osage,44,21,23
20149,KS,Pottawatomie,41,29,12
20161,KS,Riley ,193,107,86
20197,KS,Wabaunsee,23,8,15
20001,KS,Allen,28,11,17
20003,KS,Anderson,9,9,0
20005,KS,Atchison,23,13,10
20007,KS,Barber,10,4,6
20009,KS,Barton,41,18,23
20011,KS,Bourbon,11,10,1
20013,KS,Brown,22,8,14
20017,KS,Chase,9,5,4
20021,KS,Cherokee,47,18,29
20023,KS,Cheyenne,4,4,0
20025,KS,Clark,10,5,5
20027,KS,Clay,18,7,11
20029,KS,Cloud,10,9,1
20031,KS,Coffey,19,13,6
20035,KS,Cowley,44,22,22
20037,KS,Crawford,67,28,39
20039,KS,Decatur,3,3,0
20041,KS,Dickinson,31,18,13
20047,KS,Edwards,10,6,4
20049,KS,Elk,10,5,5
20051,KS,Ellis,19,19,0
20053,KS,Ellsworth,18,8,10
20057,KS,Ford,38,23,15
20059,KS,Franklin,33,29,4
20061,KS,Geary,87,34,53
20063,KS,Gove,5,4,1
20067,KS,Grant,8,3,5
20069,KS,Gray,18,12,6
20071,KS,Greeley,7,3,4
20083,KS,Hodgeman,8,4,4
20089,KS,Jewell,10,6,4
20093,KS,Kearny,20,11,9
20097,KS,Kiowa,19,7,12
20099,KS,Labette,31,18,13
20101,KS,Lane,9,4,5
20105,KS,Lincoln,13,8,5
20109,KS,Logan,4,4,0
20115,KS,Marion,9,8,1
20117,KS,Marshall,20,9,11
20113,KS,McPherson,22,19,3
20119,KS,Meade,18,7,11
20123,KS,Mitchell,21,8,13
20125,KS,Montgomery,41,29,12
20127,KS,Morris,12,7,5
20129,KS,Morton,11,6,5
20131,KS,Nemaha,21,9,12
20135,KS,Ness,13,7,6
20137,KS,Norton,10,5,5
20141,KS,Osborne,14,7,7
20143,KS,Ottawa,19,5,14
20145,KS,Pawnee,13,12,1
20147,KS,Phillips,13,8,5
20151,KS,Pratt,15,9,6
20153,KS,Rawlins,7,2,5
20157,KS,Republic,11,10,1
20159,KS,Rice,9,7,2
20165,KS,Rush,12,7,5
20167,KS,Russell,11,10,1
20169,KS,Saline,99,37,62
20171,KS,Scott,4,4,0
20175,KS,Seward,39,14,25
20179,KS,Sheridan,3,3,0
20181,KS,Sherman,6,4,2
20183,KS,Smith,5,5,0
20185,KS,Stafford,9,4,5
20189,KS,Stevens,19,8,11
20193,KS,Thomas,7,6,1
20195,KS,Trego,6,4,2
20199,KS,Wallace,8,4,4
20201,KS,Washington,7,7,0
20203,KS,Wichita,9,4,5
20205,KS,Wilson,14,10,4
20207,KS,Woodson,13,8,5
21003,KY,Allen,18,16,2
21015,KY,Boone,140,133,7
21019,KY,Boyd,31,27,4
21029,KY,Bullitt,53,38,15
21031,KY,Butler,8,6,2
21049,KY,Clark,17,13,4
21059,KY,Daviess,41,37,4
21081,KY,Grant,18,16,2
21089,KY,Greenup,18,15,3
21111,KY,Jefferson,290,238,52
21123,KY,Larue,6,5,1
21163,KY,Meade,18,10,8
21185,KY,Oldham,16,12,4
21221,KY,Trigg,10,7,3
21227,KY,Warren,87,38,49
21239,KY,Woodford,11,8,3
21011,KY,Bath,7,5,2
21027,KY,Breckinridge,10,7,3
21039,KY,Carlisle,3,2,1
21045,KY,Casey,8,6,2
21057,KY,Cumberland,6,4,2
21069,KY,Fleming,7,6,1
21083,KY,Graves,19,16,3
21085,KY,Grayson,11,8,3
21087,KY,Green,12,4,8
21095,KY,Harlan,21,17,4
21099,KY,Hart,9,6,3
21115,KY,Johnson,12,10,2
21119,KY,Knott,9,6,3
21125,KY,Laurel,59,35,24
21135,KY,Lewis,7,5,2
21139,KY,Livingston,6,5,1
21141,KY,Logan,19,17,2
21151,KY,Madison,31,28,3
21155,KY,Marion,10,7,3
21145,KY,McCracken,47,41,6
21147,KY,McCreary,4,3,1
21165,KY,Menifee,4,4,0
21169,KY,Metcalfe,13,10,3
21173,KY,Montgomery,17,15,2
21177,KY,Muhlenberg,15,13,2
21195,KY,Pike,16,8,8
21205,KY,Rowan,13,11,2
21207,KY,Russell,11,9,2
21219,KY,Todd,5,4,1
21235,KY,Whitley,19,13,6
22001,LA,Acadia,101,68,33
22005,LA,Ascension,324,270,54
22015,LA,Bossier,403,328,75
22017,LA,Caddo,684,418,266
22019,LA,Calcasieu,880,648,232
22023,LA,Cameron,79,69,10
22031,LA,De Soto,30,24,6
22033,LA,East Baton Rouge,852,739,113
22037,LA,East Feliciana,54,54,0
22043,LA,Grant,75,33,42
22045,LA,Iberia,271,188,83
22047,LA,Iberville,145,95,50
22051,LA,Jefferson,1432,627,805
22055,LA,Lafayette,796,569,227
22057,LA,Lafourche,350,267,83
22063,LA,Livingston,280,280,0
22073,LA,Ouachita,401,401,0
22075,LA,Plaquemines,209,209,0
22077,LA,Pointe Coupee,98,46,52
22079,LA,Rapides,508,414,94
22087,LA,St. Bernard,266,244,22
22089,LA,St. Charles,394,276,118
22091,LA,St. Helena,45,31,14
22093,LA,St. James,99,60,39
22095,LA,St. John the Baptist,239,237,2
22099,LA,St. Martin,182,113,69
22103,LA,St. Tammany,749,418,331
22105,LA,Tangipahoa,238,119,119
22109,LA,Terrebonne,306,306,0
22111,LA,Union,50,35,15
22113,LA,Vermilion,128,103,25
22119,LA,Webster,60,38,22
22121,LA,West Baton Rouge,196,150,46
22125,LA,West Feliciana,69,69,0
22003,LA,Allen,64,26,38
22007,LA,Assumption,80,52,28
22009,LA,Avoyelles,273,217,56
22011,LA,Beauregard,87,69,18
22013,LA,Bienville,70,42,28
22021,LA,Caldwell,30,30,0
22025,LA,Catahoula,115,22,93
22027,LA,Claiborne,92,41,51
22029,LA,Concordia,261,27,234
22035,LA,East Carroll,46,16,30
22039,LA,Evangeline,28,14,14
22041,LA,Franklin,98,98,0
22049,LA,Jackson,178,42,136
22053,LA,Jefferson Davis,75,75,0
22059,LA,La Salle,135,30,105
22061,LA,Lincoln,76,60,16
22065,LA,Madison,34,34,0
22067,LA,Morehouse,144,48,96
22069,LA,Natchitoches,180,75,105
22081,LA,Red River,59,32,27
22083,LA,Richland,133,117,16
22085,LA,Sabine,89,60,29
22097,LA,St. Landry,200,147,53
22101,LA,St. Mary,102,102,0
22107,LA,Tensas,36,19,17
22115,LA,Vernon,164,62,102
22117,LA,Washington,84,71,13
22123,LA,West Carroll,21,10,11
22127,LA,Winn,29,17,12
23001,ME,Androscoggin,32,19,13
23005,ME,Cumberland,71,59,12
23019,ME,Penobscot,36,32,4
23023,ME,Sagadahoc,21,19,2
23031,ME,York,33,30,3
23003,ME,Aroostook,27,21,6
23007,ME,Franklin,21,20,1
23009,ME,Hancock,20,19,1
23011,ME,Kennebec,23,20,3
23013,ME,Knox,22,22,0
23015,ME,Lincoln,25,23,2
23017,ME,Oxford,28,26,2
23021,ME,Piscataquis,8,7,1
23025,ME,Somerset,25,22,3
23027,ME,Waldo,21,19,2
23029,ME,Washington,13,11,2
24001,MD,Allegany,31,28,3
24003,MD,Anne Arundel ,960,698,262
24005,MD,Baltimore ,2092,"1,833",259
24009,MD,Calvert,147,122,25
24013,MD,Carroll,141,113,28
24015,MD,Cecil,106,89,17
24017,MD,Charles,423,295,128
24021,MD,Frederick,236,176,60
24025,MD,Harford,380,285,95
24027,MD,Howard,659,476,183
24031,MD,Montgomery,1904,"1,365",539
24033,MD,Prince George's ,1888,"1,675",213
24035,MD,Queen Anne's,66,60,6
24039,MD,Somerset,29,25,4
24037,MD,St. Mary's,264,115,149
24043,MD,Washington,246,100,146
24045,MD,Wicomico,108,87,21
24047,MD,Worcester,60,51,9
24011,MD,Caroline,34,30,4
24019,MD,Dorchester,42,38,4
24023,MD,Garrett,57,31,26
24029,MD,Kent,28,25,3
24041,MD,Talbot,35,32,3
26015,MI,Barry,54,30,24
26017,MI,Bay,76,32,44
26021,MI,Berrien,158,74,84
26025,MI,Calhoun,181,86,95
26027,MI,Cass,70,33,37
26037,MI,Clinton,61,26,35
26045,MI,Eaton,127,70,57
26049,MI,Genesee,247,113,134
26065,MI,Ingham,164,91,73
26075,MI,Jackson,128,52,76
26077,MI,Kalamazoo,218,130,88
26081,MI,Kent,531,207,324
26087,MI,Lapeer,79,50,29
26093,MI,Livingston,147,52,95
26099,MI,Macomb,508,241,267
26111,MI,Midland,70,32,38
26115,MI,Monroe,154,74,80
26117,MI,Montcalm,42,17,25
26121,MI,Muskegon,108,47,61
26125,MI,Oakland,1042,859,183
26139,MI,Ottawa,235,145,90
26145,MI,Saginaw,129,66,63
26147,MI,St. Clair,185,75,110
26159,MI,Van Buren,103,56,47
26161,MI,Washtenaw,303,128,175
26163,MI,Wayne,920,629,291
26001,MI,Alcona,29,12,17
26003,MI,Alger,18,9,9
26005,MI,Allegan,19,10,9
26007,MI,Alpena,27,13,14
26009,MI,Antrim,45,20,25
26011,MI,Arenac,26,13,13
26013,MI,Baraga,13,6,7
26019,MI,Benzie,33,15,18
26023,MI,Branch,35,14,21
26029,MI,Charlevoix,36,20,16
26031,MI,Cheboygan,37,20,17
26033,MI,Chippewa,32,15,17
26035,MI,Clare,31,21,10
26039,MI,Crawford,25,15,10
26041,MI,Delta,30,14,16
26043,MI,Dickinson,29,12,17
26047,MI,Emmet,47,25,22
26051,MI,Gladwin,41,16,25
26053,MI,Gogebic,24,16,8
26055,MI,Grand Traverse,122,64,58
26057,MI,Gratiot,40,25,15
26059,MI,Hillsdale,32,22,10
26061,MI,Houghton,30,21,9
26063,MI,Huron,46,20,26
26067,MI,Ionia,56,24,32
26069,MI,Iosco,22,5,17
26071,MI,Iron,19,10,9
26073,MI,Isabella,49,22,27
26079,MI,Kalkaska,34,15,19
26083,MI,Keweenaw,6,6,0
26085,MI,Lake,53,14,39
26089,MI,Leelanau,50,20,30
26091,MI,Lenawee,104,41,63
26095,MI,Luce,4,4,0
26097,MI,Mackinac,28,13,15
26101,MI,Manistee,38,16,22
26103,MI,Marquette,61,22,39
26105,MI,Mason,40,20,20
26107,MI,Mecosta,52,24,28
26109,MI,Menominee,15,15,0
26113,MI,Missaukee,26,13,13
26119,MI,Montmorency,13,13,0
26123,MI,Newaygo,27,24,3
26127,MI,Oceana,35,21,14
26129,MI,Ogemaw,36,18,18
26131,MI,Ontonagon,5,5,0
26133,MI,Osceola,36,17,19
26135,MI,Oscoda,16,10,6
26137,MI,Otsego,25,12,13
26141,MI,Presque Isle,26,13,13
26143,MI,Roscommon,39,24,15
26151,MI,Sanilac,28,25,3
26153,MI,Schoolcraft,9,2,7
26155,MI,Shiawassee,51,21,30
26149,MI,St. Joseph,58,27,31
26157,MI,Tuscola,47,22,25
26165,MI,Wexford,48,23,25
27003,MN,Anoka,256,129,127
27009,MN,Benton,70,24,46
27013,MN,Blue Earth,69,31,38
27017,MN,Carlton,52,22,30
27019,MN,Carver,148,77,71
27025,MN,Chisago,85,40,45
27027,MN,Clay,71,34,37
27037,MN,Dakota,185,82,103
27039,MN,Dodge,37,24,13
27045,MN,Fillmore,30,19,11
27053,MN,Hennepin,792,321,471
27055,MN,Houston,33,13,20
27059,MN,Isanti,56,21,35
27079,MN,Le Sueur,33,19,14
27095,MN,Mille Lacs,84,34,50
27103,MN,Nicollet,41,14,27
27109,MN,Olmsted,176,71,105
27119,MN,Polk,44,32,12
27123,MN,Ramsey,384,210,174
27139,MN,Scott,128,43,85
27141,MN,Sherburne,278,82,196
27143,MN,Sibley,24,12,12
27145,MN,Stearns,185,68,117
27137,MN,St. Louis,253,105,148
27157,MN,Wabasha,45,17,28
27163,MN,Washington,237,101,136
27171,MN,Wright,228,136,92
27001,MN,Aitkin,48,17,31
27005,MN,Becker,56,21,35
27007,MN,Beltrami,70,29,41
27011,MN,Big Stone,7,5,2
27015,MN,Brown,37,14,23
27021,MN,Cass,70,39,31
27023,MN,Chippewa,18,8,10
27029,MN,Clearwater,24,10,14
27031,MN,Cook,20,12,8
27033,MN,Cottonwood,22,10,12
27035,MN,Crow Wing,123,37,86
27041,MN,Douglas,82,33,49
27043,MN,Faribault,26,10,16
27047,MN,Freeborn,73,23,50
27049,MN,Goodhue,102,39,63
27051,MN,Grant,12,7,5
27057,MN,Hubbard,44,18,26
27061,MN,Itasca,71,30,41
27063,MN,Jackson,26,14,12
27065,MN,Kanabec,47,19,28
27067,MN,Kandiyohi,103,33,70
27069,MN,Kittson,10,5,5
27071,MN,Koochiching,20,10,10
27073,MN,Lac qui Parle ,12,7,5
27075,MN,Lake,30,17,13
27077,MN,Lake of the Woods,12,6,6
27081,MN,Lincoln,13,6,7
27083,MN,Lyon,48,17,31
27087,MN,Mahnomen,20,13,7
27089,MN,Marshall,22,12,10
27091,MN,Martin,33,14,19
27085,MN,McLeod,54,22,32
27093,MN,Meeker,46,21,25
27097,MN,Morrison,51,20,31
27099,MN,Mower,70,22,48
27101,MN,Murray,16,9,7
27105,MN,Nobles,34,13,21
27107,MN,Norman,10,7,3
27111,MN,Otter Tail,82,35,47
27113,MN,Pennington,30,8,22
27115,MN,Pine,81,31,50
27117,MN,Pipestone,24,14,10
27121,MN,Pope,15,8,7
27125,MN,Red Lake,11,8,3
27127,MN,Redwood,29,12,17
27129,MN,Renville,35,14,21
27131,MN,Rice,51,25,26
27133,MN,Rock,17,12,5
27135,MN,Roseau,20,10,10
27147,MN,Steele,28,22,6
27149,MN,Stevens,16,8,8
27151,MN,Swift,17,8,9
27153,MN,Todd,32,15,17
27155,MN,Traverse,14,6,8
27159,MN,Wadena,20,10,10
27161,MN,Waseca,28,13,15
27165,MN,Watonwan,15,7,8
27167,MN,Wilkin,16,7,9
27169,MN,Winona,72,20,52
27173,MN,Yellow Medicine,10,10,0
28045,MS,Hancock,122,68,54
28047,MS,Harrison,326,109,217
28049,MS,Hinds,383,116,267
28073,MS,Lamar,77,39,38
28093,MS,Marshall,48,27,21
28001,MS,Adams,73,39,34
28019,MS,Choctaw,14,8,6
28021,MS,Claiborne,28,12,16
28043,MS,Grenada,14,12,2
28067,MS,Jones,51,46,5
28069,MS,Kemper,17,11,6
28075,MS,Lauderdale,123,48,75
28091,MS,Marion,22,18,4
28123,MS,Scott,66,25,41
28131,MS,Stone,22,18,4
28133,MS,Sunflower,44,38,6
28149,MS,Warren,42,39,3
28151,MS,Washington,47,34,13
29003,MO,Andrew,28,15,13
29013,MO,Bates,43,19,24
29017,MO,Bollinger,16,11,5
29019,MO,Boone,75,58,17
29021,MO,Buchanan,108,77,31
29025,MO,Caldwell,13,6,7
29027,MO,Callaway,26,23,3
29031,MO,Cape Girardeau,82,42,40
29037,MO,Cass,86,68,18
29043,MO,Christian,82,46,36
29047,MO,Clay,197,124,73
29049,MO,Clinton,21,17,4
29051,MO,Cole,84,52,32
29059,MO,Dallas,22,16,6
29063,MO,DeKalb,11,6,5
29071,MO,Franklin,136,109,27
29077,MO,Greene,334,129,205
29095,MO,Jackson,128,93,35
29097,MO,Jasper,134,86,48
29099,MO,Jefferson,221,150,71
29107,MO,Lafayette,52,43,9
29113,MO,Lincoln,108,50,58
29119,MO,McDonald,30,24,6
29135,MO,Moniteau,12,7,5
29145,MO,Newton,68,35,33
29151,MO,Osage,12,9,3
29165,MO,Platte,127,83,44
29167,MO,Polk,30,17,13
29183,MO,St. Charles,167,130,37
29189,MO,St. Louis,1160,880,280
29219,MO,Warren,60,36,24
29225,MO,Webster,34,18,16
29001,MO,Adair,27,12,15
29005,MO,Atchison,10,5,5
29007,MO,Audrain,45,35,10
29009,MO,Barry,38,25,13
29015,MO,Benton,26,18,8
29023,MO,Butler,43,20,23
29029,MO,Camden,97,58,39
29033,MO,Carroll,8,7,1
29035,MO,Carter,14,9,5
29039,MO,Cedar,30,11,19
29041,MO,Chariton,15,9,6
29045,MO,Clark,11,4,7
29053,MO,Cooper,10,9,1
29055,MO,Crawford,37,23,14
29061,MO,Daviess,7,6,1
29065,MO,Dent,19,12,7
29067,MO,Douglas,11,6,5
29069,MO,Dunklin,20,12,8
29073,MO,Gasconade,10,9,1
29075,MO,Gentry,5,5,0
29079,MO,Grundy,16,6,10
29083,MO,Henry,41,26,15
29085,MO,Hickory,14,8,6
29087,MO,Holt,10,5,5
29089,MO,Howard,13,9,4
29091,MO,Howell,37,28,9
29093,MO,Iron,17,12,5
29101,MO,Johnson,57,31,26
29103,MO,Knox,4,3,1
29105,MO,Laclede,30,23,7
29109,MO,Lawrence,34,26,8
29111,MO,Lewis,12,6,6
29115,MO,Linn,7,6,1
29117,MO,Livingston,10,9,1
29121,MO,Macon,18,12,6
29125,MO,Maries,13,10,3
29127,MO,Marion,40,16,24
29129,MO,Mercer,9,3,6
29131,MO,Miller,18,15,3
29137,MO,Monroe,9,8,1
29139,MO,Montgomery,19,17,2
29141,MO,Morgan,43,27,16
29143,MO,New Madrid,16,13,3
29147,MO,Nodaway,15,13,2
29149,MO,Oregon,11,7,4
29153,MO,Ozark,14,9,5
29155,MO,Pemiscot,43,18,25
29157,MO,Perry,38,26,12
29159,MO,Pettis,50,25,25
29161,MO,Phelps,65,24,41
29163,MO,Pike,22,8,14
29169,MO,Pulaski,34,21,13
29173,MO,Ralls,10,9,1
29175,MO,Randolph,44,25,19
29179,MO,Reynolds,10,9,1
29181,MO,Ripley,10,9,1
29195,MO,Saline,37,23,14
29197,MO,Schuyler,7,4,3
29199,MO,Scotland,6,2,4
29201,MO,Scott,50,24,26
29203,MO,Shannon,8,4,4
29205,MO,Shelby,10,5,5
29185,MO,St. Clair,73,21,52
29186,MO,Ste. Genevieve,64,45,19
29187,MO,St. Francois,69,56,13
29207,MO,Stoddard,28,12,16
29209,MO,Stone,58,48,10
29211,MO,Sullivan,5,4,1
29213,MO,Taney,54,38,16
29215,MO,Texas,12,11,1
29217,MO,Vernon,35,20,15
29221,MO,Washington,35,22,13
29223,MO,Wayne,17,7,10
29227,MO,Worth,4,3,1
29229,MO,Wright,13,6,7
30009,MT,Carbon,17,10,7
30013,MT,Cascade,143,35,108
30037,MT,Golden Valley,2,2,0
30063,MT,Missoula,184,52,132
30111,MT,Yellowstone,158,51,107
30001,MT,Beaverhead,39,11,28
30005,MT,Blaine,14,8,6
30007,MT,Broadwater,28,10,18
30011,MT,Carter,3,3,0
30015,MT,Chouteau,22,9,13
30017,MT,Custer,17,6,11
30019,MT,Daniels,4,2,2
30021,MT,Dawson,51,6,45
30023,MT,Deer Lodge,28,19,9
30025,MT,Fallon,9,4,5
30027,MT,Fergus,21,8,13
30029,MT,Flathead,114,56,58
30031,MT,Gallatin,110,55,55
30033,MT,Garfield,4,3,1
30035,MT,Glacier,25,13,12
30039,MT,Granite,6,6,0
30041,MT,Hill,30,12,18
30043,MT,Jefferson,24,12,12
30045,MT,Judith Basin,5,4,1
30047,MT,Lake,45,22,23
30049,MT,Lewis and Clark,79,45,34
30051,MT,Liberty,7,5,2
30057,MT,Madison,24,11,13
30055,MT,McCone,10,4,6
30059,MT,Meagher,9,3,6
30061,MT,Mineral,17,7,10
30065,MT,Musselshell,10,9,1
30067,MT,Park,25,15,10
30071,MT,Phillips,11,7,4
30073,MT,Pondera,10,9,1
30075,MT,Powder River,4,4,0
30077,MT,Powell,10,5,5
30079,MT,Prairie,4,3,1
30081,MT,Ravalli,82,31,51
30083,MT,Richland,39,11,28
30085,MT,Roosevelt,41,17,24
30087,MT,Rosebud,24,12,12
30089,MT,Sanders,19,12,7
30091,MT,Sheridan,10,8,2
30093,MT,Silver Bow,101,51,50
30095,MT,Stillwater,17,9,8
30097,MT,Sweet Grass,13,7,6
30099,MT,Teton,12,9,3
30101,MT,Toole,20,12,8
30103,MT,Treasure,2,2,0
30105,MT,Valley,23,7,16
30107,MT,Wheatland,11,6,5
31025,NE,Cass,75,54,21
31051,NE,Dixon,14,8,6
31055,NE,Douglas,199,125,74
31079,NE,Hall,40,31,9
31081,NE,Hamilton,18,9,9
31093,NE,Howard,11,5,6
31109,NE,Lancaster,106,87,19
31153,NE,Sarpy,199,134,65
31155,NE,Saunders,20,11,9
31159,NE,Seward,17,15,2
31177,NE,Washington,52,28,24
31001,NE,Adams,30,16,14
31003,NE,Antelope,16,5,11
31005,NE,Arthur,1,1,0
31007,NE,Banner,1,1,0
31009,NE,Blaine,1,1,0
31011,NE,Boone,12,5,7
31013,NE,Box Butte,19,5,14
31015,NE,Boyd,3,3,0
31017,NE,Brown,9,5,4
31019,NE,Buffalo,45,26,19
31021,NE,Burt,5,5,0
31023,NE,Butler,18,10,8
31027,NE,Cedar,6,6,0
31029,NE,Chase,8,4,4
31031,NE,Cherry,6,5,1
31033,NE,Cheyenne,21,9,12
31035,NE,Clay,12,7,5
31037,NE,Colfax,18,10,8
31039,NE,Cuming,6,5,1
31041,NE,Custer,8,7,1
31045,NE,Dawes,14,7,7
31047,NE,Dawson,63,26,37
31049,NE,Deuel,6,5,1
31053,NE,Dodge,23,20,3
31057,NE,Dundy,9,5,4
31059,NE,Fillmore,13,7,6
31061,NE,Franklin,7,3,4
31063,NE,Frontier,9,5,4
31065,NE,Furnas,14,8,6
31067,NE,Gage,27,15,12
31071,NE,Garfield,2,2,0
31073,NE,Gosper,6,5,1
31075,NE,Grant,1,1,0
31077,NE,Greeley,3,2,1
31083,NE,Harlan,8,4,4
31085,NE,Hayes,2,1,1
31087,NE,Hitchcock,8,4,4
31089,NE,Holt,10,4,6
31091,NE,Hooker,2,2,0
31095,NE,Jefferson,16,9,7
31097,NE,Johnson,11,6,5
31099,NE,Kearney,10,5,5
31101,NE,Keith,8,7,1
31103,NE,Keya Paha,1,1,0
31105,NE,Kimball,9,4,5
31107,NE,Knox,14,5,9
31111,NE,Lincoln,57,24,33
31119,NE,Madison,61,33,28
31117,NE,McPherson,1,1,0
31123,NE,Morrill,14,9,5
31125,NE,Nance,11,7,4
31127,NE,Nemaha,10,10,0
31129,NE,Nuckolls,8,5,3
31131,NE,Otoe,29,15,14
31133,NE,Pawnee,4,3,1
31135,NE,Perkins,8,7,1
31141,NE,Platte,69,20,49
31145,NE,Red Willow,21,6,15
31149,NE,Rock,7,3,4
31151,NE,Saline,24,17,7
31157,NE,Scotts Bluff,25,17,8
31161,NE,Sheridan,15,5,10
31163,NE,Sherman,6,5,1
31173,NE,Thurston,11,6,5
31179,NE,Wayne,4,4,0
31181,NE,Webster,9,6,3
31183,NE,Wheeler,1,1,0
31185,NE,York,27,10,17
32510,NV,Carson City,93,93,0
32029,NV,Storey,27,25,2
32031,NV,Washoe,691,407,284
32001,NV,Churchill,45,39,6
32005,NV,Douglas,98,98,0
32007,NV,Elko,79,66,13
32009,NV,Esmeralda,17,12,5
32011,NV,Eureka,14,8,6
32013,NV,Humboldt,56,35,21
32015,NV,Lander,21,21,0
32017,NV,Lincoln,30,23,7
32021,NV,Mineral,23,17,6
32023,NV,Nye,123,95,28
32027,NV,Pershing,16,13,3
32033,NV,White Pine,31,25,6
33015,NH,Rockingham,51,26,25
33017,NH,Strafford,29,15,14
33003,NH,Carroll,22,12,10
33005,NH,Cheshire,22,9,13
33009,NH,Grafton,23,9,14
33013,NH,Merrimack,34,20,14
34001,NJ,Atlantic,133,110,23
34003,NJ,Bergen,585,502,83
34005,NJ,Burlington,89,71,18
34007,NJ,Camden,463,410,53
34009,NJ,Cape May,148,134,14
34011,NJ,Cumberland,63,56,7
34013,NJ,Essex,522,449,73
34015,NJ,Gloucester,109,92,17
34017,NJ,Hudson,347,222,125
34019,NJ,Hunterdon,32,28,4
34021,NJ,Mercer,183,141,42
34023,NJ,Middlesex,225,182,43
34025,NJ,Monmouth,691,438,253
34027,NJ,Morris,122,92,30
34029,NJ,Ocean,278,139,139
34031,NJ,Passaic,698,557,141
34033,NJ,Salem,262,221,41
34035,NJ,Somerset,225,166,59
34037,NJ,Sussex,147,117,30
34039,NJ,Union,249,205,44
34041,NJ,Warren,23,19,4
35013,NM,Dona Ana,203,143,60
35043,NM,Sandoval,15,12,3
35049,NM,Santa Fe,121,94,27
35061,NM,Valencia,61,55,6
35003,NM,Catron,13,8,5
35005,NM,Chaves,46,37,9
35007,NM,Colfax,11,11,0
35009,NM,Curry,26,18,8
35011,NM,De Baca,5,5,0
35015,NM,Eddy,72,60,12
35019,NM,Guadalupe,6,5,1
35023,NM,Hidalgo,11,9,2
35025,NM,Lea,69,59,10
35027,NM,Lincoln,33,23,10
35029,NM,Luna,39,31,8
35033,NM,Mora,7,5,2
35035,NM,Otero,61,38,23
35037,NM,Quay,8,7,1
35047,NM,San Miguel,13,9,4
35051,NM,Sierra,16,14,2
35053,NM,Socorro,15,12,3
35055,NM,Taos,26,22,4
35059,NM,Union,7,5,2
36001,NY,Albany,172,113,59
36007,NY,Broome,62,53,9
36015,NY,Chemung,49,44,5
36027,NY,Dutchess,129,99,30
36029,NY,Erie,197,147,50
36043,NY,Herkimer,16,6,10
36045,NY,Jefferson,57,40,17
36051,NY,Livingston,78,51,27
36053,NY,Madison,44,34,10
36055,NY,Monroe,334,279,55
36059,NY,Nassau,3218,"2,450",768
36063,NY,Niagara,155,111,44
36065,NY,Oneida,113,87,26
36067,NY,Onondaga,247,215,32
36069,NY,Ontario,114,70,44
36073,NY,Orleans,39,26,13
36075,NY,Oswego,85,68,17
36079,NY,Putnam,100,86,14
36083,NY,Rensselaer,43,35,8
36087,NY,Rockland,149,77,72
36091,NY,Saratoga,152,110,42
36093,NY,Schenectady,17,11,6
36095,NY,Schoharie,31,17,14
36103,NY,Suffolk,3040,"2,521",519
36107,NY,Tioga,55,35,20
36109,NY,Tompkins,46,40,6
36111,NY,Ulster,59,56,3
36113,NY,Warren,104,67,37
36117,NY,Wayne,69,63,6
36119,NY,Westchester,354,283,71
36003,NY,Allegany,45,26,19
36009,NY,Cattaraugus,81,57,24
36011,NY,Cayuga,37,33,4
36013,NY,Chautauqua,111,61,50
36019,NY,Clinton,25,25,0
36021,NY,Columbia,67,52,15
36023,NY,Cortland,41,36,5
36025,NY,Delaware,24,16,8
36031,NY,Essex,15,15,0
36033,NY,Franklin,18,8,10
36035,NY,Fulton,40,25,15
36037,NY,Genesee,78,50,28
36039,NY,Greene,32,28,4
36041,NY,Hamilton,6,5,1
36049,NY,Lewis,26,17,9
36057,NY,Montgomery,49,26,23
36077,NY,Otsego,20,17,3
36097,NY,Schuyler,21,18,3
36099,NY,Seneca,39,31,8
36101,NY,Steuben,50,39,11
36089,NY,St. Lawrence,33,31,2
36105,NY,Sullivan,42,42,0
36121,NY,Wyoming,31,30,1
37001,NC,Alamance,255,117,138
37003,NC,Alexander,71,39,32
37019,NC,Brunswick,261,154,107
37021,NC,Buncombe,393,247,146
37023,NC,Burke,110,88,22
37025,NC,Cabarrus,310,183,127
37027,NC,Caldwell,113,103,10
37035,NC,Catawba,194,145,49
37037,NC,Chatham,132,100,32
37049,NC,Craven,126,73,53
37051,NC,Cumberland,603,303,300
37053,NC,Currituck,96,63,33
37057,NC,Davidson,180,124,56
37059,NC,Davie,86,56,30
37063,NC,Durham,463,181,282
37065,NC,Edgecombe,134,54,80
37067,NC,Forsyth,474,206,268
37069,NC,Franklin,123,74,49
37071,NC,Gaston,215,123,92
37073,NC,Gates,13,13,0
37081,NC,Guilford,612,267,345
37087,NC,Haywood,125,68,57
37089,NC,Henderson,203,134,69
37093,NC,Hoke,122,63,59
37097,NC,Iredell,203,147,56
37101,NC,Johnston,186,114,72
37103,NC,Jones,29,18,11
37109,NC,Lincoln,158,107,51
37115,NC,Madison,43,24,19
37119,NC,Mecklenburg,1084,294,790
37127,NC,Nash,140,88,52
37129,NC,New Hanover,488,349,139
37133,NC,Onslow,264,126,138
37135,NC,Orange,140,94,46
37137,NC,Pamlico,50,22,28
37141,NC,Pender,110,64,46
37145,NC,Person,83,46,37
37147,NC,Pitt,310,130,180
37151,NC,Randolph,229,176,53
37157,NC,Rockingham,142,95,47
37159,NC,Rowan,185,124,61
37169,NC,Stokes,66,46,20
37179,NC,Union,285,203,82
37183,NC,Wake,967,378,589
37191,NC,Wayne,223,118,105
37197,NC,Yadkin,76,39,37
37005,NC,Alleghany,33,17,16
37007,NC,Anson,60,32,28
37009,NC,Ashe,62,30,32
37011,NC,Avery,49,25,24
37013,NC,Beaufort,90,55,35
37015,NC,Bertie,36,23,13
37017,NC,Bladen,85,53,32
37029,NC,Camden,21,18,3
37031,NC,Carteret,92,63,29
37033,NC,Caswell,52,35,17
37039,NC,Cherokee,67,31,36
37041,NC,Chowan,34,17,17
37043,NC,Clay,44,17,27
37045,NC,Cleveland,173,103,70
37047,NC,Columbus,118,75,43
37055,NC,Dare,144,65,79
37061,NC,Duplin,111,76,35
37075,NC,Graham,30,17,13
37079,NC,Greene,49,23,26
37083,NC,Halifax,94,62,32
37085,NC,Harnett,218,122,96
37091,NC,Hertford,53,23,30
37095,NC,Hyde,20,14,6
37099,NC,Jackson,76,53,23
37105,NC,Lee,106,67,39
37107,NC,Lenoir,121,62,59
37113,NC,Macon,76,50,26
37117,NC,Martin,40,37,3
37111,NC,McDowell,63,44,19
37121,NC,Mitchell,20,18,2
37123,NC,Montgomery,55,30,25
37125,NC,Moore,131,74,57
37131,NC,Northampton,54,31,23
37139,NC,Pasquotank,66,45,21
37143,NC,Perquimans,15,13,2
37149,NC,Polk,46,36,10
37153,NC,Richmond,88,56,32
37155,NC,Robeson,218,130,88
37161,NC,Rutherford,137,80,57
37163,NC,Sampson,133,90,43
37165,NC,Scotland,63,37,26
37167,NC,Stanly,90,87,3
37171,NC,Surry,105,77,28
37173,NC,Swain,47,27,20
37175,NC,Transylvania,82,60,22
37177,NC,Tyrrell,18,12,6
37181,NC,Vance,81,40,41
37185,NC,Warren,67,36,31
37187,NC,Washington,52,22,30
37189,NC,Watauga,76,45,31
37193,NC,Wilkes,127,71,56
37195,NC,Wilson,151,91,60
37199,NC,Yancey,38,18,20
38015,ND,Burleigh,113,52,61
38017,ND,Cass,162,110,52
38035,ND,Grand Forks,40,33,7
38059,ND,Morton,58,33,25
38065,ND,Oliver,5,4,1
38085,ND,Sioux,1,1,0
38001,ND,Adams,6,5,1
38003,ND,Barnes,9,8,1
38005,ND,Benson,4,4,0
38007,ND,Billings,6,6,0
38009,ND,Bottineau,15,11,4
38011,ND,Bowman,5,4,1
38013,ND,Burke,5,4,1
38019,ND,Cavalier,11,6,5
38021,ND,Dickey,5,4,1
38023,ND,Divide,7,7,0
38025,ND,Dunn,18,15,3
38027,ND,Eddy,5,4,1
38029,ND,Emmons,6,5,1
38031,ND,Foster,3,3,0
38033,ND,Golden Valley,5,4,1
38037,ND,Grant,4,4,0
38039,ND,Griggs,3,3,0
38041,ND,Hettinger,5,4,1
38043,ND,Kidder,3,3,0
38045,ND,LaMoure ,5,4,1
38047,ND,Logan,3,3,0
38049,ND,McHenry,8,8,0
38051,ND,McIntosh,3,3,0
38053,ND,McKenzie,63,31,32
38055,ND,McLean,39,24,15
38057,ND,Mercer,33,18,15
38061,ND,Mountrail,22,13,9
38063,ND,Nelson,6,5,1
38067,ND,Pembina,18,12,6
38069,ND,Pierce,38,3,35
38071,ND,Ramsey,7,6,1
38073,ND,Ransom,5,4,1
38075,ND,Renville,5,5,0
38077,ND,Richland,35,18,17
38079,ND,Rolette,19,10,9
38081,ND,Sargent,5,4,1
38083,ND,Sheridan,3,3,0
38087,ND,Slope,2,2,0
38089,ND,Stark,30,25,5
38091,ND,Steele,3,3,0
38093,ND,Stutsman,13,11,2
38095,ND,Towner,5,5,0
38097,ND,Traill,13,8,5
38099,ND,Walsh,19,11,8
38101,ND,Ward,90,39,51
38103,ND,Wells,3,3,0
38105,ND,Williams,80,40,40
39003,OH,Allen,147,68,79
39015,OH,Brown,43,27,16
39019,OH,Carroll,35,21,14
39041,OH,Delaware,202,93,109
39045,OH,Fairfield,142,114,28
39051,OH,Fulton,24,22,2
39057,OH,Greene,141,63,78
39089,OH,Licking,206,84,122
39093,OH,Lorain,77,66,11
39097,OH,Madison,40,32,8
39103,OH,Medina,138,55,83
39109,OH,Miami,108,49,59
39127,OH,Perry,19,13,6
39129,OH,Pickaway,85,41,44
39133,OH,Portage,142,76,66
39139,OH,Richland,128,42,86
39153,OH,Summit,406,332,74
39159,OH,Union,55,37,18
39165,OH,Warren,183,94,89
39005,OH,Ashland,77,49,28
39007,OH,Ashtabula,71,31,40
39009,OH,Athens,33,27,6
39021,OH,Champaign,29,26,3
39037,OH,Darke,66,28,38
39043,OH,Erie,85,42,43
39047,OH,Fayette,43,26,17
39063,OH,Hancock,92,36,56
39071,OH,Highland,47,30,17
39075,OH,Holmes,53,30,23
39083,OH,Knox,62,47,15
39101,OH,Marion,50,28,22
39111,OH,Monroe,27,20,7
39119,OH,Muskingum,110,73,37
39123,OH,Ottawa,63,44,19
39125,OH,Paulding,29,20,9
39145,OH,Scioto,76,37,39
39167,OH,Washington,87,43,44
39175,OH,Wyandot,28,15,13
40017,OK,Canadian,104,61,43
40027,OK,Cleveland,160,58,102
40031,OK,Comanche,41,31,10
40033,OK,Cotton,12,6,6
40037,OK,Creek,98,37,61
40047,OK,Garfield,69,26,43
40051,OK,Grady,29,19,10
40079,OK,Le Flore,20,14,6
40081,OK,Lincoln,32,15,17
40083,OK,Logan,61,30,31
40087,OK,McClain,34,21,13
40109,OK,Oklahoma,642,463,179
40111,OK,Okmulgee,17,16,1
40113,OK,Osage,73,40,33
40117,OK,Pawnee,26,9,17
40131,OK,Rogers,80,53,27
40135,OK,Sequoyah,53,23,30
40143,OK,Tulsa,631,223,408
40145,OK,Wagoner,70,32,38
40001,OK,Adair,9,9,0
40003,OK,Alfalfa,9,6,3
40005,OK,Atoka,23,8,15
40007,OK,Beaver,15,7,8
40009,OK,Beckham,40,14,26
40011,OK,Blaine,14,6,8
40013,OK,Bryan,17,15,2
40015,OK,Caddo,34,15,19
40019,OK,Carter,56,18,38
40021,OK,Cherokee,28,22,6
40023,OK,Choctaw,20,8,12
40025,OK,Cimarron,7,3,4
40029,OK,Coal,9,6,3
40035,OK,Craig,28,12,16
40039,OK,Custer,37,14,23
40041,OK,Delaware,43,17,26
40043,OK,Dewey,16,6,10
40045,OK,Ellis,18,8,10
40049,OK,Garvin,36,19,17
40053,OK,Grant,10,6,4
40055,OK,Greer,6,2,4
40057,OK,Harmon,4,3,1
40059,OK,Harper,8,5,3
40061,OK,Haskell,18,7,11
40063,OK,Hughes,7,6,1
40065,OK,Jackson,35,12,23
40067,OK,Jefferson,17,6,11
40069,OK,Johnston,24,7,17
40071,OK,Kay,24,16,8
40073,OK,Kingfisher,18,8,10
40075,OK,Kiowa,16,7,9
40077,OK,Latimer,13,6,7
40085,OK,Love,24,9,15
40093,OK,Major,13,5,8
40095,OK,Marshall,26,6,20
40097,OK,Mayes,54,28,26
40089,OK,McCurtain,21,16,5
40091,OK,McIntosh,43,15,28
40099,OK,Murray,13,6,7
40101,OK,Muskogee,99,34,65
40103,OK,Noble,24,9,15
40105,OK,Nowata,16,7,9
40107,OK,Okfuskee,16,6,10
40115,OK,Ottawa,36,15,21
40119,OK,Payne,91,36,55
40121,OK,Pittsburg,26,14,12
40123,OK,Pontotoc,41,18,23
40125,OK,Pottawatomie,29,25,4
40127,OK,Pushmataha,4,3,1
40129,OK,Roger Mills,13,8,5
40133,OK,Seminole,38,18,20
40137,OK,Stephens,36,21,15
40139,OK,Texas,35,12,23
40141,OK,Tillman,24,4,20
40149,OK,Washita,31,9,22
40151,OK,Woods,8,7,1
40153,OK,Woodward,37,12,25
41003,OR,Benton,78,65,13
41005,OR,Clackamas,468,362,106
41009,OR,Columbia,45,14,31
41017,OR,Deschutes,229,79,150
41029,OR,Jackson,168,121,47
41033,OR,Josephine,57,42,15
41039,OR,Lane,253,176,77
41043,OR,Linn,187,137,50
41047,OR,Marion,349,92,257
41051,OR,Multnomah,774,115,659
41053,OR,Polk,65,26,39
41071,OR,Yamhill,85,68,17
41001,OR,Baker,32,30,2
41007,OR,Clatsop,52,25,27
41011,OR,Coos,87,57,30
41013,OR,Crook,35,16,19
41015,OR,Curry,36,22,14
41019,OR,Douglas,145,109,36
41021,OR,Gilliam,7,6,1
41023,OR,Grant,8,8,0
41025,OR,Harney,18,12,6
41027,OR,Hood River,46,25,21
41031,OR,Jefferson,38,33,5
41035,OR,Klamath,72,25,47
41037,OR,Lake,20,20,0
41041,OR,Lincoln,84,28,56
41055,OR,Sherman,7,6,1
41057,OR,Tillamook,58,30,28
41059,OR,Umatilla,83,24,59
41061,OR,Union,34,20,14
41063,OR,Wallowa,12,6,6
41065,OR,Wasco,29,17,12
41069,OR,Wheeler,4,4,0
42001,PA,Adams,14,11,3
42003,PA,Allegheny,273,215,58
42007,PA,Beaver,27,24,3
42011,PA,Berks,108,97,11
42013,PA,Blair,29,25,4
42019,PA,Butler,30,27,3
42041,PA,Cumberland,34,28,6
42049,PA,Erie,45,38,7
42055,PA,Franklin,23,18,5
42071,PA,Lancaster,54,48,6
42081,PA,Lycoming,23,17,6
42085,PA,Mercer,19,15,4
42089,PA,Monroe,43,26,17
42091,PA,Montgomery,130,104,26
42095,PA,Northampton,66,60,6
42103,PA,Pike,23,19,4
42125,PA,Washington,32,29,3
42129,PA,Westmoreland,61,53,8
42131,PA,Wyoming,5,3,2
42133,PA,York,104,104,0
42009,PA,Bedford,11,10,1
42015,PA,Bradford,11,9,2
42031,PA,Clarion,11,8,3
42047,PA,Elk,6,5,1
42059,PA,Greene,10,8,2
42063,PA,Indiana,19,16,3
42065,PA,Jefferson,9,8,1
42073,PA,Lawrence,23,18,5
42107,PA,Schuylkill,19,15,4
42109,PA,Snyder,7,7,0
42117,PA,Tioga,8,6,2
42119,PA,Union,9,8,1
42123,PA,Warren,12,10,2
42127,PA,Wayne,16,13,3
45003,SC,Aiken,246,136,110
45007,SC,Anderson,390,220,170
45013,SC,Beaufort,317,219,98
45015,SC,Berkeley,268,150,118
45017,SC,Calhoun,32,30,2
45019,SC,Charleston,722,267,455
45023,SC,Chester,119,49,70
45031,SC,Darlington,132,61,71
45035,SC,Dorchester,271,140,131
45037,SC,Edgefield,64,37,27
45039,SC,Fairfield,51,46,5
45041,SC,Florence,229,190,39
45045,SC,Greenville,536,439,97
45051,SC,Horry,365,71,294
45053,SC,Jasper,36,31,5
45055,SC,Kershaw,72,59,13
45057,SC,Lancaster,164,112,52
45059,SC,Laurens,70,63,7
45063,SC,Lexington,437,281,156
45077,SC,Pickens,135,114,21
45079,SC,Richland,597,493,104
45081,SC,Saluda,62,21,41
45083,SC,Spartanburg,343,314,29
45085,SC,Sumter,135,109,26
45087,SC,Union,33,30,3
45091,SC,York,315,158,157
45001,SC,Abbeville,61,29,32
45005,SC,Allendale,14,12,2
45009,SC,Bamberg,13,13,0
45011,SC,Barnwell,64,28,36
45021,SC,Cherokee,92,55,37
45025,SC,Chesterfield,55,44,11
45027,SC,Clarendon,59,52,7
45029,SC,Colleton,109,47,62
45033,SC,Dillon,47,36,11
45043,SC,Georgetown,164,76,88
45047,SC,Greenwood,155,79,76
45049,SC,Hampton,40,33,7
45067,SC,Marion,59,32,27
45069,SC,Marlboro,25,21,4
45065,SC,McCormick,34,16,18
45071,SC,Newberry,102,51,51
45073,SC,Oconee,163,91,72
45075,SC,Orangeburg,121,85,36
45089,SC,Williamsburg,71,29,42
46033,SD,Custer,12,11,1
46083,SD,Lincoln,20,18,2
46087,SD,McCook,8,7,1
46093,SD,Meade,45,18,27
46099,SD,Minnehaha,207,72,135
46103,SD,Pennington,384,94,290
46125,SD,Turner,10,8,2
46127,SD,Union,28,8,20
46003,SD,Aurora,4,3,1
46005,SD,Beadle,25,5,20
46007,SD,Bennett,5,3,2
46009,SD,Bon Homme,8,3,5
46011,SD,Brookings,22,14,8
46013,SD,Brown,59,16,43
46015,SD,Brule,10,4,6
46017,SD,Buffalo,1,1,0
46019,SD,Butte,14,5,9
46021,SD,Campbell,2,2,0
46023,SD,Charles Mix,20,6,14
46025,SD,Clark,3,3,0
46027,SD,Clay,14,8,6
46029,SD,Codington,28,10,18
46031,SD,Corson,4,4,0
46035,SD,Davison,10,7,3
46037,SD,Day,5,3,2
46039,SD,Deuel,6,5,1
46041,SD,Dewey,4,3,1
46043,SD,Douglas,4,4,0
46045,SD,Edmunds,4,4,0
46047,SD,Fall River,8,6,2
46049,SD,Faulk,11,4,7
46051,SD,Grant,8,4,4
46053,SD,Gregory,4,3,1
46057,SD,Hamlin,6,5,1
46059,SD,Hand,3,2,1
46061,SD,Hanson,4,3,1
46063,SD,Harding,3,2,1
46065,SD,Hughes,48,6,42
46067,SD,Hutchinson,3,3,0
46069,SD,Hyde,2,2,0
46071,SD,Jackson,3,2,1
46073,SD,Jerauld,5,4,1
46075,SD,Jones,2,2,0
46077,SD,Kingsbury,6,5,1
46079,SD,Lake,13,7,6
46081,SD,Lawrence,37,13,24
46085,SD,Lyman,5,4,1
46091,SD,Marshall,11,6,5
46089,SD,McPherson,3,3,0
46095,SD,Mellette,5,4,1
46097,SD,Miner,4,3,1
46101,SD,Moody,8,3,5
46105,SD,Perkins,7,6,1
46107,SD,Potter,3,2,1
46109,SD,Roberts,34,5,29
46111,SD,Sanborn,3,3,0
46115,SD,Spink,13,8,5
46117,SD,Stanley,6,5,1
46119,SD,Sully,3,3,0
46121,SD,Todd,1,1,0
46123,SD,Tripp,4,3,1
46129,SD,Walworth,13,5,8
46135,SD,Yankton,32,12,20
46137,SD,Ziebach,2,2,0
47001,TN,Anderson,169,60,109
47009,TN,Blount,281,152,129
47011,TN,Bradley,219,115,104
47013,TN,Campbell,92,47,45
47015,TN,Cannon,36,18,18
47019,TN,Carter,127,124,3
47021,TN,Cheatham,79,39,40
47023,TN,Chester,46,15,31
47033,TN,Crockett,36,17,19
47043,TN,Dickson,133,65,68
47047,TN,Fayette,87,44,43
47057,TN,Grainger,45,22,23
47063,TN,Hamblen,106,41,65
47065,TN,Hamilton,403,164,239
47169,TN,Trousdale,41,20,21
47073,TN,Hawkins,119,59,60
47081,TN,Hickman,47,24,23
47089,TN,Jefferson,104,53,51
47093,TN,Knox,954,433,521
47105,TN,Loudon,78,47,31
47111,TN,Macon,54,27,27
47113,TN,Madison,262,110,152
47115,TN,Marion,56,28,28
47119,TN,Maury,158,83,75
47125,TN,Montgomery,350,105,245
47129,TN,Morgan,44,21,23
47139,TN,Polk,49,22,27
47145,TN,Roane,76,43,33
47147,TN,Robertson,152,51,101
47149,TN,Rutherford,426,228,198
47153,TN,Sequatchie,44,23,21
47157,TN,Shelby,1809,613,"1,196"
47159,TN,Smith,58,26,32
47163,TN,Sullivan,274,123,151
47165,TN,Sumner,285,96,189
47167,TN,Tipton,99,60,39
47171,TN,Unicoi,40,24,16
47173,TN,Union,51,31,20
47179,TN,Washington,220,97,123
47187,TN,Williamson,249,160,89
47189,TN,Wilson,250,114,136
47003,TN,Bedford,90,40,50
47005,TN,Benton,60,20,40
47007,TN,Bledsoe,40,15,25
47017,TN,Carroll,65,24,41
47025,TN,Claiborne,110,38,72
47027,TN,Clay,26,15,11
47029,TN,Cocke,71,38,33
47031,TN,Coffee,130,47,83
47035,TN,Cumberland,109,52,57
47039,TN,Decatur,28,13,15
47041,TN,DeKalb,48,26,22
47045,TN,Dyer,88,36,52
47049,TN,Fentress,45,18,27
47051,TN,Franklin,71,43,28
47053,TN,Gibson,84,37,47
47055,TN,Giles,66,32,34
47059,TN,Greene,155,59,96
47061,TN,Grundy,38,16,22
47067,TN,Hancock,34,12,22
47069,TN,Hardeman,68,28,40
47071,TN,Hardin,50,22,28
47075,TN,Haywood,43,19,24
47077,TN,Henderson,71,32,39
47079,TN,Henry,67,34,33
47083,TN,Houston,25,11,14
47085,TN,Humphreys,40,23,17
47087,TN,Jackson,37,14,23
47091,TN,Johnson,42,19,23
47095,TN,Lake,22,9,13
47097,TN,Lauderdale,66,19,47
47099,TN,Lawrence,100,55,45
47101,TN,Lewis,16,15,1
47103,TN,Lincoln,82,32,50
47117,TN,Marshall,51,26,25
47107,TN,McMinn,74,32,42
47109,TN,McNairy,37,17,20
47121,TN,Meigs,37,18,19
47123,TN,Monroe,55,49,6
47127,TN,Moore,34,14,20
47131,TN,Obion,55,23,32
47133,TN,Overton,57,24,33
47135,TN,Perry,30,14,16
47137,TN,Pickett,12,8,4
47141,TN,Putnam,146,69,77
47143,TN,Rhea,55,54,1
47151,TN,Scott,66,29,37
47155,TN,Sevier,214,106,108
47161,TN,Stewart,51,20,31
47175,TN,Van Buren,19,9,10
47177,TN,Warren,96,49,47
47181,TN,Wayne,49,14,35
47183,TN,Weakley,44,21,23
47185,TN,White,64,29,35
48007,TX,Aransas,72,26,46
48009,TX,Archer,20,9,11
48011,TX,Armstrong,8,4,4
48015,TX,Austin,71,43,28
48019,TX,Bandera,64,27,37
48021,TX,Bastrop,211,76,135
48027,TX,Bell,309,104,205
48037,TX,Bowie,42,35,7
48039,TX,Brazoria,341,129,212
48041,TX,Brazos,227,99,128
48051,TX,Burleson,43,17,26
48055,TX,Caldwell,96,32,64
48059,TX,Callahan,12,5,7
48061,TX,Cameron,501,114,387
48077,TX,Clay,23,12,11
48085,TX,Collin,470,156,314
48091,TX,Comal,283,151,132
48099,TX,Coryell,75,33,42
48107,TX,Crosby,14,5,9
48113,TX,Dallas,2243,423,"1,820"
48135,TX,Ector,229,80,149
48139,TX,Ellis,220,80,140
48141,TX,El Paso,1012,253,759
48145,TX,Falls,26,7,19
48157,TX,Fort Bend,800,549,251
48175,TX,Goliad,29,14,15
48181,TX,Grayson,160,65,95
48183,TX,Gregg,256,106,150
48199,TX,Hardin,67,29,38
48209,TX,Hays,301,144,157
48215,TX,Hidalgo,773,280,493
48221,TX,Hood,138,53,85
48229,TX,Hudspeth,41,14,27
48231,TX,Hunt,139,46,93
48235,TX,Irion,12,5,7
48245,TX,Jefferson,435,169,266
48251,TX,Johnson,146,93,53
48257,TX,Kaufman,232,82,150
48259,TX,Kendall,81,48,33
48281,TX,Lampasas,37,17,20
48291,TX,Liberty,75,52,23
48303,TX,Lubbock,499,212,287
48309,TX,McLennan,378,97,281
48325,TX,Medina,71,33,38
48329,TX,Midland,198,77,121
48339,TX,Montgomery,789,461,328
48351,TX,Newton,21,11,10
48355,TX,Nueces,298,53,245
48359,TX,Oldham,11,6,5
48361,TX,Orange,131,63,68
48367,TX,Parker,126,89,37
48375,TX,Potter,219,98,121
48381,TX,Randall,196,88,108
48395,TX,Robertson,31,13,18
48397,TX,Rockwall,108,34,74
48401,TX,Rusk,78,41,37
48409,TX,San Patricio,115,54,61
48423,TX,Smith,369,172,197
48439,TX,Tarrant,1337,371,966
48441,TX,Taylor,233,83,150
48451,TX,Tom Green,163,61,102
48453,TX,Travis,1630,345,"1,285"
48469,TX,Victoria,204,114,90
48473,TX,Waller,86,61,25
48479,TX,Webb,331,267,64
48485,TX,Wichita,211,82,129
48491,TX,Williamson,510,224,286
48493,TX,Wilson,79,33,46
48497,TX,Wise,142,64,78
48001,TX,Anderson,74,36,38
48003,TX,Andrews,36,14,22
48005,TX,Angelina,112,49,63
48023,TX,Baylor,8,3,5
48025,TX,Bee,51,21,30
48031,TX,Blanco,30,12,18
48033,TX,Borden,3,2,1
48035,TX,Bosque,41,20,21
48043,TX,Brewster,15,14,1
48045,TX,Briscoe,3,3,0
48047,TX,Brooks,35,11,24
48049,TX,Brown,68,29,39
48053,TX,Burnet,132,45,87
48057,TX,Calhoun,62,25,37
48063,TX,Camp,18,7,11
48067,TX,Cass,36,21,15
48069,TX,Castro,19,6,13
48073,TX,Cherokee,73,34,39
48075,TX,Childress,21,5,16
48079,TX,Cochran,12,6,6
48081,TX,Coke,6,5,1
48093,TX,Comanche,31,11,20
48095,TX,Concho,12,7,5
48103,TX,Crane,11,6,5
48115,TX,Dawson,19,7,12
48119,TX,Delta,23,11,12
48125,TX,Dickens,7,3,4
48127,TX,Dimmit,70,31,39
48131,TX,Duval,46,26,20
48133,TX,Eastland,31,12,19
48137,TX,Edwards,12,6,6
48143,TX,Erath,60,21,39
48149,TX,Fayette,49,26,23
48153,TX,Floyd,11,7,4
48155,TX,Foard,4,3,1
48159,TX,Franklin,25,11,14
48163,TX,Frio,40,19,21
48165,TX,Gaines,37,16,21
48169,TX,Garza,35,8,27
48173,TX,Glasscock,5,4,1
48177,TX,Gonzales,55,20,35
48179,TX,Gray,43,13,30
48185,TX,Grimes,56,31,25
48189,TX,Hale,69,69,0
48193,TX,Hamilton,14,7,7
48195,TX,Hansford,13,7,6
48197,TX,Hardeman,11,7,4
48205,TX,Hartley,5,5,0
48207,TX,Haskell,12,4,8
48211,TX,Hemphill,14,7,7
48217,TX,Hill,68,33,35
48219,TX,Hockley,26,11,15
48223,TX,Hopkins,65,25,40
48225,TX,Houston,48,21,27
48227,TX,Howard,57,21,36
48233,TX,Hutchinson,33,13,20
48237,TX,Jack,29,11,18
48239,TX,Jackson,34,12,22
48241,TX,Jasper,66,18,48
48249,TX,Jim Wells,70,64,6
48255,TX,Karnes,66,32,34
48261,TX,Kenedy,18,11,7
48263,TX,Kent,7,3,4
48265,TX,Kerr,94,45,49
48267,TX,Kimble,13,8,5
48271,TX,Kinney,15,7,8
48275,TX,Knox,9,3,6
48277,TX,Lamar,76,27,49
48279,TX,Lamb,32,13,19
48283,TX,La Salle,139,25,114
48285,TX,Lavaca,34,15,19
48287,TX,Lee,42,14,28
48289,TX,Leon,46,28,18
48293,TX,Limestone,89,23,66
48295,TX,Lipscomb,10,6,4
48299,TX,Llano,50,26,24
48313,TX,Madison,31,13,18
48315,TX,Marion,12,11,1
48321,TX,Matagorda,74,38,36
48323,TX,Maverick,95,39,56
48307,TX,McCulloch,13,6,7
48311,TX,McMullen,12,10,2
48331,TX,Milam,60,19,41
48333,TX,Mills,18,7,11
48335,TX,Mitchell,20,5,15
48337,TX,Montague,29,8,21
48341,TX,Moore,49,17,32
48343,TX,Morris,22,9,13
48345,TX,Motley,2,2,0
48347,TX,Nacogdoches,86,40,46
48353,TX,Nolan,36,12,24
48357,TX,Ochiltree,20,8,12
48365,TX,Panola,61,39,22
48369,TX,Parmer,18,6,12
48371,TX,Pecos,37,22,15
48373,TX,Polk,107,48,59
48377,TX,Presidio,27,8,19
48379,TX,Rains,27,11,16
48383,TX,Reagan,22,14,8
48385,TX,Real,10,5,5
48387,TX,Red River,25,13,12
48389,TX,Reeves,49,21,28
48391,TX,Refugio,36,13,23
48393,TX,Roberts,6,5,1
48399,TX,Runnels,26,6,20
48403,TX,Sabine,19,9,10
48405,TX,San Augustine,19,8,11
48407,TX,San Jacinto,66,36,30
48411,TX,San Saba,10,5,5
48413,TX,Schleicher,11,5,6
48415,TX,Scurry,38,9,29
48417,TX,Shackelford,12,4,8
48427,TX,Starr,108,48,60
48429,TX,Stephens,20,7,13
48431,TX,Sterling,4,4,0
48433,TX,Stonewall,9,3,6
48437,TX,Swisher,10,4,6
48445,TX,Terry,37,12,25
48455,TX,Trinity,17,11,6
48461,TX,Upton,20,10,10
48463,TX,Uvalde,69,32,37
48465,TX,Val Verde,65,44,21
48467,TX,Van Zandt,71,30,41
48471,TX,Walker,83,40,43
48475,TX,Ward,33,14,19
48481,TX,Wharton,75,44,31
48483,TX,Wheeler,22,10,12
48487,TX,Wilbarger,18,7,11
48489,TX,Willacy,45,16,29
48495,TX,Winkler,30,9,21
48499,TX,Wood,60,24,36
48501,TX,Yoakum,21,9,12
48503,TX,Young,36,11,25
49003,UT,Box Elder,83,28,55
49005,UT,Cache,146,55,91
49011,UT,Davis,312,145,167
49023,UT,Juab,26,14,12
49029,UT,Morgan,12,10,2
49035,UT,Salt Lake,580,427,153
49045,UT,Tooele,90,34,56
49049,UT,Utah,378,145,233
49053,UT,Washington,159,44,115
49057,UT,Weber,70,70,0
49001,UT,Beaver,70,23,47
49007,UT,Carbon,54,29,25
49009,UT,Daggett,25,10,15
49013,UT,Duchesne,58,24,34
49015,UT,Emery,39,27,12
49017,UT,Garfield,29,13,16
49019,UT,Grand,31,17,14
49021,UT,Iron,78,37,41
49025,UT,Kane,46,14,32
49027,UT,Millard,54,34,20
49031,UT,Piute,5,4,1
49033,UT,Rich,10,4,6
49037,UT,San Juan,28,12,16
49039,UT,Sanpete,58,20,38
49041,UT,Sevier,24,22,2
49043,UT,Summit,98,60,38
49047,UT,Uintah,79,25,54
49051,UT,Wasatch,55,28,27
49055,UT,Wayne,6,5,1
50007,VT,Chittenden,17,15,2
50011,VT,Franklin,9,9,0
50013,VT,Grand Isle,1,1,0
50001,VT,Addison,6,6,0
50003,VT,Bennington,15,12,3
50005,VT,Caledonia,12,9,3
50009,VT,Essex,2,2,0
50015,VT,Lamoille,24,11,13
50017,VT,Orange,16,10,6
50019,VT,Orleans,9,7,2
50021,VT,Rutland,16,12,4
50023,VT,Washington,13,11,2
50025,VT,Windham,18,13,5
50027,VT,Windsor,14,13,1
51003,VA,Albemarle,156,128,28
51007,VA,Amelia,28,17,11
51009,VA,Amherst,44,44,0
51011,VA,Appomattox,23,22,1
51013,VA,Arlington,464,361,103
51015,VA,Augusta,82,71,11
51019,VA,Bedford,91,83,8
51023,VA,Botetourt,119,96,23
51029,VA,Buckingham,26,19,7
51031,VA,Campbell,68,59,9
51033,VA,Caroline,68,48,20
51036,VA,Charles City,16,10,6
51041,VA,Chesterfield,605,503,102
51043,VA,Clarke,27,15,12
51045,VA,Craig,15,10,5
51047,VA,Culpeper,96,82,14
51053,VA,Dinwiddie,53,51,2
51059,VA,Fairfax ,1617,"1,414",203
51061,VA,Fauquier,147,122,25
51063,VA,Floyd,32,22,10
51065,VA,Fluvanna,49,35,14
51067,VA,Franklin,94,73,21
51069,VA,Frederick,140,124,16
51071,VA,Giles,34,23,11
51073,VA,Gloucester,98,83,15
51075,VA,Goochland,47,36,11
51079,VA,Greene,42,25,17
51085,VA,Hanover,254,237,17
51087,VA,Henrico ,807,639,168
51093,VA,Isle of Wight,52,48,4
51095,VA,James City,102,96,6
51101,VA,King William,32,19,13
51107,VA,Loudoun,642,531,111
51115,VA,Mathews,18,11,7
51121,VA,Montgomery,117,107,10
51125,VA,Nelson,22,18,4
51127,VA,New Kent,48,32,16
51145,VA,Powhatan,61,42,19
51149,VA,Prince George,79,54,25
51153,VA,Prince William,744,611,133
51155,VA,Pulaski,48,46,2
51157,VA,Rappahannock,18,17,1
51161,VA,Roanoke,155,141,14
51165,VA,Rockingham,78,62,16
51169,VA,Scott,37,30,7
51177,VA,Spotsylvania,230,181,49
51179,VA,Stafford,240,173,67
51183,VA,Sussex,48,43,5
51187,VA,Warren,70,53,17
51191,VA,Washington,80,59,21
51199,VA,York,94,86,8
51001,VA,Accomack,68,57,11
51005,VA,Alleghany,65,46,19
51017,VA,Bath,19,12,7
51021,VA,Bland,18,10,8
51025,VA,Brunswick,38,27,11
51027,VA,Buchanan,46,33,13
51035,VA,Carroll,42,36,6
51037,VA,Charlotte,36,33,3
51049,VA,Cumberland,22,17,5
51051,VA,Dickenson,25,14,11
51057,VA,Essex,21,10,11
51077,VA,Grayson,32,26,6
51081,VA,Greensville,34,21,13
51083,VA,Halifax,38,31,7
51089,VA,Henry,131,118,13
51091,VA,Highland,12,7,5
51097,VA,King and Queen,20,12,8
51099,VA,King George,58,40,18
51103,VA,Lancaster,38,29,9
51105,VA,Lee,34,34,0
51109,VA,Louisa,64,47,17
51111,VA,Lunenburg,19,13,6
51113,VA,Madison,34,21,13
51117,VA,Mecklenburg,52,50,2
51119,VA,Middlesex,42,30,12
51131,VA,Northampton,84,66,18
51133,VA,Northumberland,33,22,11
51135,VA,Nottoway,24,14,10
51137,VA,Orange,49,40,9
51139,VA,Page,72,55,17
51141,VA,Patrick,69,54,15
51143,VA,Pittsylvania,141,122,19
51147,VA,Prince Edward,31,31,0
51159,VA,Richmond,23,15,8
51163,VA,Rockbridge,40,37,3
51167,VA,Russell,50,35,15
51171,VA,Shenandoah,62,57,5
51173,VA,Smyth,45,45,0
51175,VA,Southampton,80,68,12
51181,VA,Surry,21,11,10
51185,VA,Tazewell,82,58,24
51193,VA,Westmoreland,54,40,14
51195,VA,Wise,65,49,16
51197,VA,Wythe,46,37,9
53003,WA,Asotin,30,13,17
53005,WA,Benton,71,58,13
53007,WA,Chelan,73,57,16
53011,WA,Clark,211,134,77
53013,WA,Columbia,9,8,1
53015,WA,Cowlitz,47,41,6
53017,WA,Douglas,33,27,6
53021,WA,Franklin,85,27,58
53033,WA,King,321,230,91
53035,WA,Kitsap,140,117,23
53051,WA,Pend Oreille,34,14,20
53053,WA,Pierce,328,268,60
53057,WA,Skagit,117,54,63
53059,WA,Skamania,20,17,3
53061,WA,Snohomish,341,273,68
53063,WA,Spokane,182,119,63
53065,WA,Stevens,53,26,27
53067,WA,Thurston,215,83,132
53071,WA,Walla Walla,33,26,7
53073,WA,Whatcom,187,86,101
53077,WA,Yakima,81,55,26
53001,WA,Adams,35,16,19
53009,WA,Clallam,43,35,8
53019,WA,Ferry,17,11,6
53023,WA,Garfield,15,8,7
53025,WA,Grant,66,50,16
53027,WA,Grays Harbor,73,60,13
53029,WA,Island,45,38,7
53031,WA,Jefferson,45,23,22
53037,WA,Kittitas,71,32,39
53039,WA,Klickitat,39,20,19
53041,WA,Lewis,50,35,15
53043,WA,Lincoln,24,14,10
53045,WA,Mason,96,52,44
53047,WA,Okanogan,35,30,5
53049,WA,Pacific,42,13,29
53055,WA,San Juan,32,20,12
53069,WA,Wahkiakum,19,8,11
53075,WA,Whitman,21,18,3
54003,WV,Berkeley,68,60,8
54005,WV,Boone,29,24,5
54009,WV,Brooke,27,17,10
54011,WV,Cabell,63,43,20
54015,WV,Clay,8,3,5
54019,WV,Fayette,38,34,4
54027,WV,Hampshire,23,19,4
54029,WV,Hancock,32,29,3
54037,WV,Jefferson,33,27,6
54039,WV,Kanawha,135,100,35
54043,WV,Lincoln,7,6,1
54051,WV,Marshall,35,32,3
54057,WV,Mineral,16,14,2
54061,WV,Monongalia,42,39,3
54069,WV,Ohio,36,34,2
54077,WV,Preston,22,20,2
54079,WV,Putnam,61,42,19
54081,WV,Raleigh,65,48,17
54099,WV,Wayne,24,20,4
54105,WV,Wirt,3,3,0
54001,WV,Barbour,10,9,1
54007,WV,Braxton,9,8,1
54013,WV,Calhoun,3,2,1
54017,WV,Doddridge,10,8,2
54021,WV,Gilmer,4,4,0
54023,WV,Grant,11,8,3
54025,WV,Greenbrier,32,31,1
54031,WV,Hardy,15,13,2
54033,WV,Harrison,53,51,2
54035,WV,Jackson,22,14,8
54041,WV,Lewis,21,15,6
54045,WV,Logan,22,20,2
54049,WV,Marion,47,32,15
54053,WV,Mason,33,19,14
54047,WV,McDowell,16,14,2
54055,WV,Mercer,38,27,11
54059,WV,Mingo,29,21,8
54063,WV,Monroe,8,8,0
54065,WV,Morgan,12,11,1
54067,WV,Nicholas,27,21,6
54071,WV,Pendleton,3,3,0
54073,WV,Pleasants,7,6,1
54075,WV,Pocahontas,13,8,5
54083,WV,Randolph,19,14,5
54085,WV,Ritchie,10,6,4
54087,WV,Roane,9,6,3
54089,WV,Summers,7,6,1
54091,WV,Taylor,15,8,7
54093,WV,Tucker,7,5,2
54095,WV,Tyler,11,10,1
54097,WV,Upshur,14,12,2
54101,WV,Webster,5,4,1
54103,WV,Wetzel,14,12,2
54109,WV,Wyoming,20,20,0
55009,WI,Brown,320,158,162
55015,WI,Calumet,53,25,28
55017,WI,Chippewa,70,51,19
55021,WI,Columbia,109,41,68
55025,WI,Dane,533,435,98
55031,WI,Douglas,77,29,48
55035,WI,Eau Claire,109,41,68
55039,WI,Fond du Lac,122,58,64
55045,WI,Green,44,32,12
55049,WI,Iowa,37,20,17
55059,WI,Kenosha,330,119,211
55061,WI,Kewaunee,34,32,2
55063,WI,La Crosse,112,42,70
55073,WI,Marathon,180,68,112
55079,WI,Milwaukee,615,298,317
55083,WI,Oconto,58,26,32
55087,WI,Outagamie,179,73,106
55089,WI,Ozaukee,99,78,21
55093,WI,Pierce,56,48,8
55101,WI,Racine,214,136,78
55105,WI,Rock,208,99,109
55117,WI,Sheboygan,181,71,110
55109,WI,St. Croix,88,80,8
55131,WI,Washington,167,70,97
55133,WI,Waukesha,356,158,198
55139,WI,Winnebago,186,128,58
55001,WI,Adams,58,28,30
55003,WI,Ashland,42,33,9
55005,WI,Barron,68,31,37
55007,WI,Bayfield,43,20,23
55011,WI,Buffalo,25,11,14
55013,WI,Burnett,33,17,16
55019,WI,Clark,47,25,22
55023,WI,Crawford,29,23,6
55027,WI,Dodge,169,69,100
55029,WI,Door,65,52,13
55033,WI,Dunn,55,27,28
55037,WI,Florence,20,12,8
55041,WI,Forest,37,17,20
55043,WI,Grant,50,28,22
55047,WI,Green Lake,41,16,25
55051,WI,Iron,20,20,0
55053,WI,Jackson,49,23,26
55055,WI,Jefferson,115,93,22
55057,WI,Juneau,53,41,12
55065,WI,Lafayette,32,31,1
55067,WI,Langlade,40,19,21
55069,WI,Lincoln,65,30,35
55071,WI,Manitowoc,94,63,31
55075,WI,Marinette,63,32,31
55077,WI,Marquette,42,42,0
55078,WI,Menominee,10,9,1
55081,WI,Monroe,52,23,29
55085,WI,Oneida,86,37,49
55091,WI,Pepin,18,7,11
55095,WI,Polk,70,28,42
55097,WI,Portage,101,48,53
55099,WI,Price,30,20,10
55103,WI,Richland,32,32,0
55107,WI,Rusk,30,27,3
55111,WI,Sauk,143,47,96
55113,WI,Sawyer,48,26,22
55115,WI,Shawano,111,39,72
55119,WI,Taylor,39,18,21
55121,WI,Trempealeau,55,25,30
55123,WI,Vernon,44,24,20
55125,WI,Vilas,70,35,35
55127,WI,Walworth,201,80,121
55129,WI,Washburn,22,14,8
55135,WI,Waupaca,101,40,61
55137,WI,Waushara,54,24,30
55141,WI,Wood,70,40,30
56021,WY,Laramie,155,50,105
56025,WY,Natrona,163,60,103
56001,WY,Albany,43,40,3
56003,WY,Big Horn,27,12,15
56005,WY,Campbell,66,43,23
56007,WY,Carbon,33,17,16
56011,WY,Crook,21,15,6
56013,WY,Fremont,36,33,3
56017,WY,Hot Springs,12,10,2
56019,WY,Johnson,31,29,2
56023,WY,Lincoln,42,26,16
56029,WY,Park,50,18,32
56031,WY,Platte,13,10,3
56033,WY,Sheridan,57,38,19
56035,WY,Sublette,32,28,4
56037,WY,Sweetwater,99,43,56
56041,WY,Uinta,48,35,13
56043,WY,Washakie,16,14,2
56045,WY,Weston,8,8,0
