FIPS,State,County,Total_law,"Total
officers","Total
civilians"
1001,AL,Autauga,43,32,11
1003,AL,Baldwin,319,135,184
1007,AL,Bibb,12,11,1
1009,AL,Blount,48,44,4
1033,AL,Colbert,57,31,26
1055,AL,Etowah,178,67,111
1061,AL,Geneva,25,12,13
1063,AL,Greene,33,13,20
1065,AL,Hale,31,11,20
1067,AL,Henry,19,15,4
1069,AL,Houston,171,72,99
1073,AL,Jefferson,690,530,160
1077,AL,Lauderdale,74,51,23
1079,AL,Lawrence,59,26,33
1081,AL,Lee,170,81,89
1083,AL,Limestone,120,48,72
1085,AL,Lowndes,42,17,25
1089,AL,Madison,339,131,208
1097,AL,Mobile,552,180,372
1101,AL,Montgomery,175,127,48
1103,AL,Morgan,182,55,127
1107,AL,Pickens,35,10,25
1113,AL,Russell,117,39,78
1117,AL,Shelby,221,131,90
1115,AL,St. Clair,108,51,57
1125,AL,Tuscaloosa,204,105,99
1129,AL,Washington,22,10,12
1005,AL,Barbour,58,26,32
1011,AL,Bullock,13,6,7
1013,AL,Butler,18,15,3
1025,AL,Clarke,47,14,33
1027,AL,Clay,27,11,16
1029,AL,Cleburne,28,10,18
1031,AL,Coffee,60,29,31
1035,AL,Conecuh,38,11,27
1037,AL,Coosa,23,10,13
1053,AL,Escambia,89,33,56
1071,AL,Jackson,81,35,46
1087,AL,Macon,28,16,12
1091,AL,Marengo,25,10,15
1093,AL,Marion,31,15,16
1095,AL,Marshall,74,38,36
1099,AL,Monroe,51,18,33
1105,AL,Perry,19,7,12
1109,AL,Pike,35,21,14
1111,AL,Randolph,35,16,19
1119,AL,Sumter,25,8,17
1121,AL,Talladega,95,42,53
1123,AL,Tallapoosa,55,23,32
1127,AL,Walker,76,32,44
1131,AL,Wilcox,22,10,12
1133,AL,Winston,29,10,19
4003,AZ,Cochise,180,86,94
4005,AZ,Coconino,239,61,178
4013,AZ,Maricopa,3443,670,"2,773"
4015,AZ,Mohave,246,83,163
4019,AZ,Pima,1417,478,939
4021,AZ,Pinal,479,207,272
4025,AZ,Yavapai,193,120,73
4027,AZ,Yuma,331,82,249
4001,AZ,Apache,72,25,47
4007,AZ,Gila,130,51,79
4009,AZ,Graham,82,23,59
4011,AZ,Greenlee,42,16,26
4012,AZ,La Paz,90,38,52
4017,AZ,Navajo,135,47,88
4023,AZ,Santa Cruz,83,35,48
5007,AR,Benton,241,163,78
5025,AR,Cleveland,12,8,4
5031,AR,Craighead,113,40,73
5033,AR,Crawford,78,35,43
5035,AR,Crittenden,144,39,105
5045,AR,Faulkner,163,50,113
5047,AR,Franklin,25,12,13
5051,AR,Garland,181,54,127
5053,AR,Grant,18,16,2
5069,AR,Jefferson,102,48,54
5079,AR,Lincoln,26,11,15
5081,AR,Little River,34,15,19
5085,AR,Lonoke,69,35,34
5087,AR,Madison,21,19,2
5091,AR,Miller,36,25,11
5105,AR,Perry,24,12,12
5111,AR,Poinsett,44,16,28
5119,AR,Pulaski,534,410,124
5125,AR,Saline,107,57,50
5131,AR,Sebastian,147,45,102
5143,AR,Washington,303,156,147
5001,AR,Arkansas,11,11,0
5003,AR,Ashley,22,19,3
5005,AR,Baxter,60,33,27
5009,AR,Boone,56,26,30
5011,AR,Bradley,7,5,2
5013,AR,Calhoun,12,6,6
5015,AR,Carroll,64,20,44
5017,AR,Chicot,8,7,1
5019,AR,Clark,33,17,16
5021,AR,Clay,20,10,10
5023,AR,Cleburne,49,26,23
5027,AR,Columbia,42,22,20
5029,AR,Conway,44,21,23
5037,AR,Cross,40,18,22
5039,AR,Dallas,28,9,19
5041,AR,Desha,8,7,1
5043,AR,Drew,15,14,1
5049,AR,Fulton,18,7,11
5055,AR,Greene,26,23,3
5057,AR,Hempstead,58,25,33
5059,AR,Hot Spring,34,19,15
5061,AR,Howard,24,11,13
5063,AR,Independence,41,37,4
5065,AR,Izard,37,22,15
5067,AR,Jackson,32,14,18
5071,AR,Johnson,35,12,23
5073,AR,Lafayette,27,9,18
5075,AR,Lawrence,37,16,21
5077,AR,Lee,10,5,5
5083,AR,Logan,46,14,32
5089,AR,Marion,22,20,2
5093,AR,Mississippi,94,42,52
5095,AR,Monroe,14,6,8
5097,AR,Montgomery,24,11,13
5099,AR,Nevada,30,6,24
5101,AR,Newton,21,12,9
5103,AR,Ouachita,48,17,31
5107,AR,Phillips,20,14,6
5109,AR,Pike,24,19,5
5113,AR,Polk,29,16,13
5115,AR,Pope,88,35,53
5117,AR,Prairie,31,9,22
5121,AR,Randolph,25,12,13
5127,AR,Scott,28,9,19
5129,AR,Searcy,18,7,11
5133,AR,Sevier,35,30,5
5135,AR,Sharp,26,14,12
5123,AR,St. Francis,42,19,23
5137,AR,Stone,25,12,13
5139,AR,Union,66,30,36
5141,AR,Van Buren,37,21,16
5145,AR,White,104,53,51
5147,AR,Woodruff,11,7,4
5149,AR,Yell,29,16,13
6001,CA,Alameda,1496,950,546
6007,CA,Butte,252,101,151
6013,CA,Contra Costa,928,612,316
6017,CA,El Dorado,344,154,190
6019,CA,Fresno,1182,414,768
6025,CA,Imperial,272,187,85
6029,CA,Kern,1155,779,376
6031,CA,Kings,289,85,204
6037,CA,Los Angeles,15930,"9,565","6,365"
6039,CA,Madera,121,86,35
6041,CA,Marin,298,194,104
6047,CA,Merced,255,122,133
6053,CA,Monterey,430,295,135
6055,CA,Napa,134,100,34
6059,CA,Orange,3723,"1,888","1,835"
6061,CA,Placer,534,248,286
6065,CA,Riverside,3750,"1,788","1,962"
6067,CA,Sacramento,1992,"1,348",644
6069,CA,San Benito,59,23,36
6071,CA,San Bernardino,3342,"1,927","1,415"
6073,CA,San Diego,4344,"2,601","1,743"
6075,CA,San Francisco,1044,857,187
6077,CA,San Joaquin,737,293,444
6079,CA,San Luis Obispo,418,303,115
6081,CA,San Mateo,746,334,412
6083,CA,Santa Barbara,674,477,197
6085,CA,Santa Clara,1716,"1,316",400
6087,CA,Santa Cruz,334,148,186
6089,CA,Shasta,198,138,60
6095,CA,Solano,512,122,390
6097,CA,Sonoma,581,223,358
6099,CA,Stanislaus,706,527,179
6101,CA,Sutter,128,105,23
6107,CA,Tulare,791,563,228
6111,CA,Ventura,1231,761,470
6113,CA,Yolo,262,84,178
6115,CA,Yuba,163,126,37
6003,CA,Alpine,16,13,3
6005,CA,Amador,94,49,45
6009,CA,Calaveras,113,58,55
6011,CA,Colusa,59,40,19
6015,CA,Del Norte,52,21,31
6021,CA,Glenn,73,33,40
6023,CA,Humboldt,245,187,58
6027,CA,Inyo,78,38,40
6033,CA,Lake,122,91,31
6035,CA,Lassen,80,58,22
6043,CA,Mariposa,78,62,16
6045,CA,Mendocino,202,131,71
6049,CA,Modoc,30,20,10
6051,CA,Mono,41,20,21
6057,CA,Nevada,152,59,93
6063,CA,Plumas,66,36,30
6091,CA,Sierra,12,6,6
6093,CA,Siskiyou,103,81,22
6103,CA,Tehama,107,73,34
6105,CA,Trinity,50,36,14
6109,CA,Tuolumne,131,60,71
8001,CO,Adams,583,400,183
8005,CO,Arapahoe,568,243,325
8013,CO,Boulder,396,108,288
8019,CO,Clear Creek,67,25,42
8035,CO,Douglas,522,351,171
8039,CO,Elbert,45,36,9
8041,CO,El Paso,842,525,317
8047,CO,Gilpin,58,35,23
8059,CO,Jefferson,761,532,229
8069,CO,Larimer,408,276,132
8077,CO,Mesa,232,131,101
8093,CO,Park,55,30,25
8119,CO,Teller,75,47,28
8123,CO,Weld,405,129,276
8003,CO,Alamosa,46,23,23
8007,CO,Archuleta,39,17,22
8009,CO,Baca,13,5,8
8011,CO,Bent,30,13,17
8015,CO,Chaffee,58,21,37
8017,CO,Cheyenne,10,6,4
8021,CO,Conejos,32,12,20
8023,CO,Costilla,14,8,6
8025,CO,Crowley,15,8,7
8027,CO,Custer,17,11,6
8029,CO,Delta,65,36,29
8033,CO,Dolores,9,5,4
8037,CO,Eagle,82,46,36
8045,CO,Garfield,128,96,32
8049,CO,Grand,51,24,27
8051,CO,Gunnison,29,14,15
8053,CO,Hinsdale,4,3,1
8055,CO,Huerfano,40,19,21
8057,CO,Jackson,12,5,7
8061,CO,Kiowa,8,5,3
8063,CO,Kit Carson,29,6,23
8065,CO,Lake,21,7,14
8067,CO,La Plata,116,91,25
8071,CO,Las Animas,32,12,20
8073,CO,Lincoln,26,10,16
8075,CO,Logan,45,20,25
8079,CO,Mineral,7,4,3
8081,CO,Moffat,38,18,20
8083,CO,Montezuma,67,27,40
8085,CO,Montrose,86,48,38
8087,CO,Morgan,48,43,5
8089,CO,Otero,23,22,1
8091,CO,Ouray,8,8,0
8095,CO,Phillips,4,4,0
8097,CO,Pitkin,55,22,33
8099,CO,Prowers,29,10,19
8103,CO,Rio Blanco,27,13,14
8105,CO,Rio Grande,43,17,26
8107,CO,Routt,52,23,29
8109,CO,Saguache,17,10,7
8111,CO,San Juan,2,2,0
8113,CO,San Miguel,32,12,20
8115,CO,Sedgwick,3,2,1
8117,CO,Summit,74,53,21
8121,CO,Washington,31,10,21
8125,CO,Yuma,21,7,14
10003,DE,New Castle,463,387,76
12001,FL,Alachua,378,268,110
12003,FL,Baker,63,44,19
12005,FL,Bay,273,208,65
12009,FL,Brevard,1282,558,724
12011,FL,Broward,1329,390,939
12015,FL,Charlotte,448,309,139
12017,FL,Citrus,328,205,123
12019,FL,Clay,579,277,302
12021,FL,Collier,904,570,334
12033,FL,Escambia,655,417,238
12035,FL,Flagler,289,212,77
12039,FL,Gadsden,67,44,23
12041,FL,Gilchrist,66,49,17
12053,FL,Hernando,557,252,305
12055,FL,Highlands,342,147,195
12057,FL,Hillsborough,3313,"1,245","2,068"
12061,FL,Indian River,479,190,289
12065,FL,Jefferson,59,26,33
12069,FL,Lake,703,463,240
12071,FL,Lee,1504,"1,030",474
12073,FL,Leon,715,271,444
12075,FL,Levy,151,115,36
12081,FL,Manatee,1147,753,394
12083,FL,Marion,778,545,233
12085,FL,Martin,387,260,127
12086,FL,Miami-Dade,4068,"2,953","1,115"
12089,FL,Nassau,257,140,117
12091,FL,Okaloosa,444,323,121
12095,FL,Orange,2264,"1,581",683
12097,FL,Osceola,637,411,226
12099,FL,Palm Beach,3623,"1,644","1,979"
12103,FL,Pinellas,2385,827,"1,558"
12105,FL,Polk,1170,652,518
12113,FL,Santa Rosa,439,220,219
12115,FL,Sarasota,974,414,560
12117,FL,Seminole,1236,437,799
12109,FL,St. Johns,695,333,362
12111,FL,St. Lucie,741,316,425
12127,FL,Volusia,734,424,310
12129,FL,Wakulla,141,56,85
12131,FL,Walton,534,263,271
12007,FL,Bradford,88,41,47
12013,FL,Calhoun,33,25,8
12023,FL,Columbia,201,153,48
12027,FL,DeSoto,115,56,59
12043,FL,Glades,130,32,98
12045,FL,Gulf,46,32,14
12047,FL,Hamilton,60,19,41
12049,FL,Hardee,105,76,29
12051,FL,Hendry,162,86,76
12063,FL,Jackson,74,49,25
12067,FL,Lafayette,34,13,21
12077,FL,Liberty,32,25,7
12079,FL,Madison,81,64,17
12087,FL,Monroe,508,196,312
12107,FL,Putnam,212,120,92
12123,FL,Taylor,80,55,25
12133,FL,Washington,82,42,40
13015,GA,Bartow,227,186,41
13021,GA,Bibb,495,408,87
13027,GA,Brooks,45,24,21
13029,GA,Bryan,63,42,21
13033,GA,Burke,120,76,44
13045,GA,Carroll,194,113,81
13047,GA,Catoosa,120,72,48
13051,GA,Chatham,144,125,19
13057,GA,Cherokee,358,282,76
13063,GA,Clayton,480,347,133
13067,GA,Cobb,737,438,299
13067,GA,Cobb,697,628,69
13073,GA,Columbia,338,276,62
13077,GA,Coweta,267,166,101
13085,GA,Dawson,113,71,42
13089,GA,DeKalb,946,693,253
13095,GA,Dougherty,234,211,23
13097,GA,Douglas,337,298,39
13101,GA,Echols,9,8,1
13103,GA,Effingham,156,80,76
13113,GA,Fayette,201,133,68
13115,GA,Floyd,173,84,89
13115,GA,Floyd,81,76,5
13117,GA,Forsyth,441,360,81
13121,GA,Fulton,913,701,212
13121,GA,Fulton,77,49,28
13127,GA,Glynn,120,114,6
13135,GA,Gwinnett,1007,764,243
13139,GA,Hall,431,293,138
13143,GA,Haralson,77,75,2
13145,GA,Harris,81,79,2
13149,GA,Heard,36,22,14
13151,GA,Henry,313,256,57
13151,GA,Henry,259,217,42
13153,GA,Houston,335,133,202
13159,GA,Jasper,44,29,15
13169,GA,Jones,78,39,39
13171,GA,Lamar,62,35,27
13173,GA,Lanier,21,18,3
13183,GA,Long,30,28,2
13195,GA,Madison,95,52,43
13197,GA,Marion,14,6,8
13191,GA,McIntosh,80,52,28
13199,GA,Meriwether,49,27,22
13213,GA,Murray,72,45,27
13217,GA,Newton,290,168,122
13219,GA,Oconee,96,62,34
13223,GA,Paulding,265,226,39
13225,GA,Peach,60,30,30
13231,GA,Pike,51,28,23
13247,GA,Rockdale,270,246,24
13255,GA,Spalding,176,95,81
13297,GA,Walton,206,188,18
13321,GA,Worth,42,27,15
13001,GA,Appling,68,29,39
13005,GA,Bacon,29,11,18
13007,GA,Baker,9,8,1
13009,GA,Baldwin,119,59,60
13011,GA,Banks,64,46,18
13019,GA,Berrien,49,26,23
13023,GA,Bleckley,43,17,26
13043,GA,Candler,29,18,11
13049,GA,Charlton,30,18,12
13055,GA,Chattooga,46,28,18
13061,GA,Clay,7,6,1
13065,GA,Clinch,15,12,3
13069,GA,Coffee,125,55,70
13075,GA,Cook,52,28,24
13081,GA,Crisp,99,59,40
13087,GA,Decatur,63,49,14
13091,GA,Dodge,56,23,33
13093,GA,Dooly,75,37,38
13099,GA,Early,39,18,21
13105,GA,Elbert,62,33,29
13111,GA,Fannin,56,40,16
13119,GA,Franklin,57,36,21
13123,GA,Gilmer,107,61,46
13129,GA,Gordon,122,82,40
13131,GA,Grady,23,19,4
13137,GA,Habersham,87,52,35
13141,GA,Hancock,46,26,20
13147,GA,Hart,32,27,5
13155,GA,Irwin,23,15,8
13157,GA,Jackson,112,98,14
13163,GA,Jefferson,50,47,3
13175,GA,Laurens,108,67,41
13209,GA,Montgomery,21,11,10
13229,GA,Pierce,53,21,32
13251,GA,Screven,22,8,14
13261,GA,Sumter,98,74,24
13269,GA,Taylor,22,11,11
13277,GA,Tift,103,51,52
13281,GA,Towns,38,19,19
13283,GA,Treutlen,20,8,12
13291,GA,Union,46,41,5
13307,GA,Webster,7,7,0
13319,GA,Wilkinson,28,15,13
15009,HI,Maui,433,334,99
15001,HI,Hawaii,564,434,130
15007,HI,Kauai,186,132,54
16001,ID,Ada,720,167,553
16005,ID,Bannock,125,42,83
16015,ID,Boise,23,13,10
16019,ID,Bonneville,191,71,120
16023,ID,Butte,14,4,10
16027,ID,Canyon,282,70,212
16041,ID,Franklin,15,10,5
16045,ID,Gem,34,13,21
16051,ID,Jefferson,60,22,38
16053,ID,Jerome,55,22,33
16055,ID,Kootenai,297,97,200
16069,ID,Nez Perce,77,22,55
16073,ID,Owyhee,28,12,16
16077,ID,Power,26,10,16
16083,ID,Twin Falls,118,45,73
16003,ID,Adams,24,8,16
16007,ID,Bear Lake,14,8,6
16009,ID,Benewah,28,10,18
16011,ID,Bingham,85,37,48
16013,ID,Blaine,64,50,14
16017,ID,Bonner,99,41,58
16021,ID,Boundary,27,8,19
16025,ID,Camas,6,4,2
16029,ID,Caribou,26,9,17
16031,ID,Cassia,78,33,45
16033,ID,Clark,7,3,4
16035,ID,Clearwater,32,15,17
16037,ID,Custer,17,9,8
16039,ID,Elmore,68,22,46
16043,ID,Fremont,38,21,17
16047,ID,Gooding,34,16,18
16049,ID,Idaho,38,18,20
16057,ID,Latah,53,29,24
16059,ID,Lemhi,23,7,16
16061,ID,Lewis,16,8,8
16063,ID,Lincoln,12,9,3
16065,ID,Madison,62,23,39
16067,ID,Minidoka,32,21,11
16071,ID,Oneida,14,9,5
16075,ID,Payette,49,18,31
16079,ID,Shoshone,37,15,22
16081,ID,Teton,20,11,9
16085,ID,Valley,41,17,24
16087,ID,Washington,35,14,21
17003,IL,Alexander,13,7,6
17005,IL,Bond,23,12,11
17019,IL,Champaign,154,66,88
17031,IL,Cook,5418,"1,849","3,569"
17043,IL,DuPage,486,391,95
17057,IL,Fulton,42,20,22
17063,IL,Grundy,45,30,15
17073,IL,Henry,65,22,43
17077,IL,Jackson,86,32,54
17089,IL,Kane,122,87,35
17091,IL,Kankakee,191,49,142
17093,IL,Kendall,118,60,58
17097,IL,Lake,227,162,65
17115,IL,Macon,151,48,103
17117,IL,Macoupin,49,19,30
17119,IL,Madison,167,85,82
17123,IL,Marshall,17,8,9
17111,IL,McHenry,346,98,248
17113,IL,McLean,130,51,79
17131,IL,Mercer,30,12,18
17147,IL,Piatt,36,14,22
17161,IL,Rock Island,154,65,89
17167,IL,Sangamon,204,77,127
17179,IL,Tazewell,60,41,19
17183,IL,Vermilion,97,41,56
17197,IL,Will,596,238,358
17201,IL,Winnebago,331,116,215
17009,IL,Brown,8,7,1
17017,IL,Cass,8,7,1
17025,IL,Clay,18,12,6
17029,IL,Coles,29,21,8
17033,IL,Crawford,24,17,7
17035,IL,Cumberland,15,5,10
17041,IL,Douglas,25,12,13
17045,IL,Edgar,6,6,0
17049,IL,Effingham,46,20,26
17051,IL,Fayette,17,11,6
17053,IL,Ford,26,20,6
17055,IL,Franklin,40,16,24
17059,IL,Gallatin,4,4,0
17061,IL,Greene,6,6,0
17067,IL,Hancock,23,11,12
17075,IL,Iroquois,15,13,2
17079,IL,Jasper,15,7,8
17081,IL,Jefferson,61,20,41
17085,IL,Jo Daviess,38,18,20
17105,IL,Livingston,66,30,36
17107,IL,Logan,26,23,3
17125,IL,Mason,22,9,13
17109,IL,McDonough,24,14,10
17135,IL,Montgomery,31,13,18
17145,IL,Perry,21,6,15
17149,IL,Pike,30,13,17
17155,IL,Putnam,13,8,5
17171,IL,Scott,7,3,4
17173,IL,Shelby,28,14,14
17177,IL,Stephenson,38,28,10
17185,IL,Wabash,12,5,7
17191,IL,Wayne,21,9,12
17195,IL,Whiteside,63,20,43
18005,IN,Bartholomew,105,43,62
18013,IN,Brown,44,16,28
18047,IN,Franklin,11,11,0
18059,IN,Hancock,82,41,41
18067,IN,Howard,148,35,113
18081,IN,Johnson,139,123,16
18089,IN,Lake,441,157,284
,IN,La Porte,159,68,91
18095,IN,Madison,101,46,55
18105,IN,Monroe,60,46,14
18127,IN,Porter,75,66,9
18145,IN,Shelby,98,33,65
18141,IN,St. Joseph,284,116,168
18023,IN,Clinton,58,20,38
18051,IN,Gibson,46,16,30
18055,IN,Greene,60,20,40
18071,IN,Jackson,74,17,57
18075,IN,Jay,47,13,34
18079,IN,Jennings,20,17,3
18083,IN,Knox,64,28,36
18085,IN,Kosciusko,100,32,68
18107,IN,Montgomery,71,25,46
18113,IN,Noble,74,48,26
18149,IN,Starke,36,13,23
18151,IN,Steuben,53,23,30
18179,IN,Wells,16,16,0
18181,IN,White,45,16,29
19011,IA,Benton,35,14,21
19013,IA,Black Hawk,123,74,49
19015,IA,Boone,31,13,18
19017,IA,Bremer,38,13,25
19049,IA,Dallas,72,29,43
19061,IA,Dubuque,91,79,12
19075,IA,Grundy,16,12,4
19077,IA,Guthrie,14,9,5
19085,IA,Harrison,11,10,1
19099,IA,Jasper,47,17,30
19103,IA,Johnson,92,72,20
19105,IA,Jones,27,11,16
19113,IA,Linn,195,129,66
19121,IA,Madison,18,8,10
19129,IA,Mills,27,12,15
19153,IA,Polk,525,157,368
19155,IA,Pottawattamie,201,53,148
19163,IA,Scott,166,49,117
19169,IA,Story,89,32,57
19181,IA,Warren,36,20,16
19183,IA,Washington,45,17,28
19193,IA,Woodbury,113,40,73
19001,IA,Adair,13,4,9
19003,IA,Adams,8,8,0
19005,IA,Allamakee,21,10,11
19007,IA,Appanoose,16,8,8
19019,IA,Buchanan,30,13,17
19021,IA,Buena Vista,36,14,22
19023,IA,Butler,18,12,6
19025,IA,Calhoun,12,7,5
19029,IA,Cass,12,9,3
19031,IA,Cedar,39,14,25
19033,IA,Cerro Gordo,73,20,53
19035,IA,Cherokee,21,8,13
19037,IA,Chickasaw,16,10,6
19039,IA,Clarke,22,7,15
19041,IA,Clay,25,11,14
19043,IA,Clayton,29,13,16
19045,IA,Clinton,47,25,22
19047,IA,Crawford,21,11,10
19051,IA,Davis,17,6,11
19053,IA,Decatur,16,6,10
19055,IA,Delaware,21,14,7
19057,IA,Des Moines,26,22,4
19059,IA,Dickinson,20,9,11
19063,IA,Emmet,18,9,9
19065,IA,Fayette,38,12,26
19067,IA,Floyd,19,11,8
19069,IA,Franklin,10,7,3
19071,IA,Fremont,27,10,17
19073,IA,Greene,18,8,10
19079,IA,Hamilton,31,11,20
19081,IA,Hancock,9,8,1
19083,IA,Hardin,30,11,19
19089,IA,Howard,17,9,8
19091,IA,Humboldt,21,8,13
19093,IA,Ida,16,9,7
19095,IA,Iowa,29,14,15
19097,IA,Jackson,19,10,9
19101,IA,Jefferson,14,12,2
19107,IA,Keokuk,12,6,6
19109,IA,Kossuth,25,10,15
19111,IA,Lee,37,18,19
19115,IA,Louisa,31,11,20
19117,IA,Lucas,13,5,8
19119,IA,Lyon,22,11,11
19123,IA,Mahaska,26,10,16
19125,IA,Marion,38,17,21
19127,IA,Marshall,55,19,36
19131,IA,Mitchell,20,10,10
19133,IA,Monona,18,8,10
19139,IA,Muscatine,81,21,60
19141,IA,O'Brien,28,9,19
19143,IA,Osceola,14,9,5
19145,IA,Page,17,9,8
19147,IA,Palo Alto,17,8,9
19149,IA,Plymouth,34,12,22
19151,IA,Pocahontas,17,7,10
19157,IA,Poweshiek,13,12,1
19159,IA,Ringgold,13,6,7
19161,IA,Sac,22,9,13
19165,IA,Shelby,10,9,1
19167,IA,Sioux,41,14,27
19171,IA,Tama,23,13,10
19173,IA,Taylor,13,8,5
19175,IA,Union,13,6,7
19177,IA,Van Buren,12,6,6
19179,IA,Wapello,44,13,31
19185,IA,Wayne,16,8,8
19187,IA,Webster,36,17,19
19189,IA,Winnebago,8,7,1
19191,IA,Winneshiek,26,11,15
19195,IA,Worth,25,13,12
19197,IA,Wright,25,10,15
20045,KS,Douglas,159,77,82
20061,KS,Geary,105,33,72
20079,KS,Harvey,25,23,2
20085,KS,Jackson,43,22,21
20087,KS,Jefferson,39,23,16
20091,KS,Johnson,635,475,160
20103,KS,Leavenworth,97,62,35
20107,KS,Linn,33,18,15
20121,KS,Miami,61,32,29
20149,KS,Pottawatomie,43,30,13
20161,KS,Riley,206,108,98
20173,KS,Sedgwick,516,177,339
20177,KS,Shawnee,182,112,70
20191,KS,Sumner,35,30,5
20197,KS,Wabaunsee,23,10,13
20001,KS,Allen,30,12,18
20011,KS,Bourbon,16,13,3
20013,KS,Brown,26,9,17
20017,KS,Chase,10,5,5
20019,KS,Chautauqua,15,6,9
20021,KS,Cherokee,51,24,27
20023,KS,Cheyenne,6,5,1
20025,KS,Clark,10,5,5
20027,KS,Clay,13,7,6
20029,KS,Cloud,9,8,1
20031,KS,Coffey,41,12,29
20035,KS,Cowley,27,24,3
20037,KS,Crawford,36,31,5
20039,KS,Decatur,3,3,0
20041,KS,Dickinson,24,21,3
20047,KS,Edwards,10,6,4
20049,KS,Elk,10,5,5
20051,KS,Ellis,34,17,17
20053,KS,Ellsworth,20,7,13
20057,KS,Ford,35,26,9
20059,KS,Franklin,45,30,15
20063,KS,Gove,5,4,1
20065,KS,Graham,8,3,5
20067,KS,Grant,15,5,10
20069,KS,Gray,18,11,7
20071,KS,Greeley,8,4,4
20073,KS,Greenwood,22,13,9
20075,KS,Hamilton,6,6,0
20081,KS,Haskell,15,10,5
20089,KS,Jewell,10,5,5
20093,KS,Kearny,16,9,7
20095,KS,Kingman,20,8,12
20099,KS,Labette,20,18,2
20101,KS,Lane,10,5,5
20105,KS,Lincoln,13,8,5
20109,KS,Logan,5,5,0
20111,KS,Lyon,30,25,5
20115,KS,Marion,17,11,6
20117,KS,Marshall,26,11,15
20113,KS,McPherson,22,19,3
20123,KS,Mitchell,9,8,1
20125,KS,Montgomery,39,25,14
20127,KS,Morris,12,8,4
20129,KS,Morton,12,6,6
20131,KS,Nemaha,18,9,9
20133,KS,Neosho,30,16,14
20135,KS,Ness,11,6,5
20137,KS,Norton,9,5,4
20141,KS,Osborne,14,7,7
20143,KS,Ottawa,18,5,13
20145,KS,Pawnee,12,11,1
20147,KS,Phillips,14,9,5
20151,KS,Pratt,17,10,7
20153,KS,Rawlins,4,3,1
20157,KS,Republic,15,9,6
20159,KS,Rice,9,9,0
20163,KS,Rooks,17,6,11
20165,KS,Rush,12,7,5
20167,KS,Russell,11,10,1
20169,KS,Saline,49,38,11
20171,KS,Scott,9,5,4
20175,KS,Seward,37,15,22
20179,KS,Sheridan,4,4,0
20181,KS,Sherman,11,5,6
20183,KS,Smith,6,6,0
20187,KS,Stanton,11,7,4
20195,KS,Trego,6,4,2
20199,KS,Wallace,3,3,0
20201,KS,Washington,8,8,0
20203,KS,Wichita,9,4,5
20207,KS,Woodson,11,7,4
21003,KY,Allen,16,14,2
21017,KY,Bourbon,12,11,1
21019,KY,Boyd,46,34,12
21023,KY,Bracken,6,5,1
21029,KY,Bullitt,50,35,15
21031,KY,Butler,10,7,3
21043,KY,Carter,11,7,4
21049,KY,Clark,16,12,4
21059,KY,Daviess,66,35,31
21061,KY,Edmonson,9,6,3
21067,KY,Fayette,89,62,27
21081,KY,Grant,18,16,2
21089,KY,Greenup,17,14,3
21093,KY,Hardin,56,40,16
21101,KY,Henderson,24,19,5
21111,KY,Jefferson,277,223,54
21117,KY,Kenton,43,35,8
21117,KY,Kenton,39,37,2
21123,KY,Larue,7,5,2
21163,KY,Meade,18,16,2
21185,KY,Oldham,16,13,3
21185,KY,Oldham,41,38,3
21191,KY,Pendleton,9,8,1
21211,KY,Shelby,25,22,3
21215,KY,Spencer,11,5,6
21221,KY,Trigg,10,7,3
21227,KY,Warren,89,50,39
21001,KY,Adair,8,6,2
21005,KY,Anderson,21,19,2
21007,KY,Ballard,11,10,1
21009,KY,Barren,23,18,5
21011,KY,Bath,3,2,1
21021,KY,Boyle,15,14,1
21025,KY,Breathitt,2,2,0
21027,KY,Breckinridge,15,10,5
21033,KY,Caldwell,11,8,3
21035,KY,Calloway,34,25,9
21039,KY,Carlisle,3,2,1
21041,KY,Carroll,7,5,2
21045,KY,Casey,17,10,7
21051,KY,Clay,16,10,6
21055,KY,Crittenden,6,5,1
21057,KY,Cumberland,5,3,2
21065,KY,Estill,5,3,2
21069,KY,Fleming,7,6,1
21071,KY,Floyd,20,10,10
21073,KY,Franklin,36,33,3
21075,KY,Fulton,5,4,1
21079,KY,Garrard,3,2,1
21079,KY,Garrard,8,8,0
21083,KY,Graves,20,17,3
21085,KY,Grayson,16,9,7
21087,KY,Green,4,4,0
21095,KY,Harlan,21,18,3
21099,KY,Hart,18,8,10
21105,KY,Hickman,5,3,2
21107,KY,Hopkins,40,32,8
21109,KY,Jackson,9,8,1
21115,KY,Johnson,10,8,2
21119,KY,Knott,5,5,0
21127,KY,Lawrence,13,11,2
21131,KY,Leslie,8,7,1
21133,KY,Letcher,9,5,4
21135,KY,Lewis,8,6,2
21137,KY,Lincoln,11,8,3
21139,KY,Livingston,10,9,1
21141,KY,Logan,26,23,3
21143,KY,Lyon,10,7,3
21151,KY,Madison,34,31,3
21155,KY,Marion,10,7,3
21157,KY,Marshall,42,31,11
21159,KY,Martin,4,1,3
21161,KY,Mason,19,11,8
21145,KY,McCracken,54,49,5
21165,KY,Menifee,5,5,0
21167,KY,Mercer,12,9,3
21169,KY,Metcalfe,5,4,1
21171,KY,Monroe,6,5,1
21173,KY,Montgomery,18,16,2
21175,KY,Morgan,6,5,1
21177,KY,Muhlenberg,19,17,2
21181,KY,Nicholas,3,2,1
21187,KY,Owen,6,5,1
21189,KY,Owsley,4,3,1
21195,KY,Pike,36,23,13
21197,KY,Powell,5,3,2
21199,KY,Pulaski,47,39,8
21201,KY,Robertson,2,1,1
21203,KY,Rockcastle,8,6,2
21205,KY,Rowan,16,14,2
21213,KY,Simpson,18,12,6
21217,KY,Taylor,15,12,3
21219,KY,Todd,8,6,2
21223,KY,Trimble,1,1,0
21229,KY,Washington,14,8,6
21231,KY,Wayne,16,14,2
21233,KY,Webster,16,7,9
21235,KY,Whitley,19,14,5
22001,LA,Acadia,104,61,43
22005,LA,Ascension,354,285,69
22007,LA,Assumption,83,59,24
22015,LA,Bossier,414,330,84
22017,LA,Caddo,615,414,201
22019,LA,Calcasieu,869,591,278
22023,LA,Cameron,82,71,11
22031,LA,De Soto,146,101,45
22033,LA,East Baton Rouge,841,717,124
22037,LA,East Feliciana,53,53,0
22045,LA,Iberia,176,112,64
22047,LA,Iberville,134,77,57
22057,LA,Lafourche,336,228,108
22063,LA,Livingston,304,304,0
22073,LA,Ouachita,392,392,0
22075,LA,Plaquemines,257,257,0
22077,LA,Pointe Coupee,103,57,46
22079,LA,Rapides,474,379,95
22089,LA,St. Charles,411,233,178
22091,LA,St. Helena,47,29,18
22093,LA,St. James,103,59,44
22095,LA,St. John the Baptist,248,225,23
22099,LA,St. Martin,191,146,45
22111,LA,Union,46,28,18
22113,LA,Vermilion,123,100,23
22121,LA,West Baton Rouge,198,63,135
22125,LA,West Feliciana,67,67,0
22003,LA,Allen,103,28,75
22011,LA,Beauregard,88,68,20
22013,LA,Bienville,64,40,24
22025,LA,Catahoula,130,22,108
22027,LA,Claiborne,70,31,39
22029,LA,Concordia,293,26,267
22035,LA,East Carroll,46,17,29
22039,LA,Evangeline,46,18,28
22041,LA,Franklin,118,118,0
22049,LA,Jackson,265,41,224
22059,LA,La Salle,47,30,17
22061,LA,Lincoln,77,58,19
22065,LA,Madison,33,23,10
22069,LA,Natchitoches,168,90,78
22081,LA,Red River,70,42,28
22083,LA,Richland,145,115,30
22085,LA,Sabine,89,89,0
22097,LA,St. Landry,204,87,117
22101,LA,St. Mary,145,145,0
22107,LA,Tensas,30,19,11
22115,LA,Vernon,118,64,54
22117,LA,Washington,75,65,10
22119,LA,Webster,150,122,28
22123,LA,West Carroll,17,8,9
22127,LA,Winn,37,37,0
23001,ME,Androscoggin,24,22,2
23005,ME,Cumberland,74,62,12
23019,ME,Penobscot,41,36,5
23023,ME,Sagadahoc,21,19,2
23031,ME,York,33,30,3
23003,ME,Aroostook,26,19,7
23007,ME,Franklin,20,19,1
23009,ME,Hancock,22,20,2
23011,ME,Kennebec,27,24,3
23013,ME,Knox,22,21,1
23015,ME,Lincoln,25,23,2
23017,ME,Oxford,26,24,2
23021,ME,Piscataquis,10,9,1
23025,ME,Somerset,27,23,4
23027,ME,Waldo,23,21,2
23029,ME,Washington,18,16,2
24001,MD,Allegany,34,32,2
24003,MD,Anne Arundel,101,78,23
24003,MD,Anne Arundel,1000,773,227
24005,MD,Baltimore,83,73,10
24005,MD,Baltimore,2102,"1,869",233
24009,MD,Calvert,164,138,26
24013,MD,Carroll,273,122,151
24015,MD,Cecil,113,95,18
24017,MD,Charles,429,288,141
24021,MD,Frederick,257,186,71
24025,MD,Harford,389,302,87
24027,MD,Howard,73,54,19
24027,MD,Howard,682,476,206
24031,MD,Montgomery,196,160,36
24031,MD,Montgomery,1970,"1,406",564
24033,MD,Prince George's,1790,"1,551",239
24035,MD,Queen Anne's,70,62,8
24039,MD,Somerset,29,25,4
24037,MD,St. Mary's,216,145,71
24043,MD,Washington,246,106,140
24045,MD,Wicomico,113,92,21
24047,MD,Worcester,60,52,8
24011,MD,Caroline,43,39,4
24019,MD,Dorchester,44,39,5
24023,MD,Garrett,54,39,15
24029,MD,Kent,29,24,5
24041,MD,Talbot,37,34,3
26017,MI,Bay,82,35,47
26021,MI,Berrien,153,70,83
26025,MI,Calhoun,179,85,94
26027,MI,Cass,69,32,37
26037,MI,Clinton,61,26,35
26045,MI,Eaton,118,63,55
26049,MI,Genesee,247,113,134
26065,MI,Ingham,156,79,77
26067,MI,Ionia,17,15,2
26075,MI,Jackson,131,52,79
26077,MI,Kalamazoo,211,129,82
26081,MI,Kent,548,207,341
26087,MI,Lapeer,80,49,31
26093,MI,Livingston,135,58,77
26099,MI,Macomb,545,272,273
26111,MI,Midland,70,30,40
26115,MI,Monroe,154,74,80
26117,MI,Montcalm,42,17,25
26121,MI,Muskegon,107,46,61
26125,MI,Oakland,1089,912,177
26139,MI,Ottawa,239,140,99
26145,MI,Saginaw,116,61,55
26155,MI,Shiawassee,51,21,30
26147,MI,St. Clair,184,84,100
26161,MI,Washtenaw,302,125,177
26163,MI,Wayne,923,632,291
26001,MI,Alcona,29,11,18
26003,MI,Alger,18,9,9
26005,MI,Allegan,103,55,48
26007,MI,Alpena,28,13,15
26009,MI,Antrim,51,21,30
26011,MI,Arenac,26,14,12
26013,MI,Baraga,13,6,7
26015,MI,Barry,52,30,22
26019,MI,Benzie,33,15,18
26023,MI,Branch,35,14,21
26029,MI,Charlevoix,30,19,11
26031,MI,Cheboygan,38,22,16
26033,MI,Chippewa,34,16,18
26035,MI,Clare,32,26,6
26039,MI,Crawford,25,15,10
26041,MI,Delta,10,10,0
26043,MI,Dickinson,29,12,17
26047,MI,Emmet,49,27,22
26051,MI,Gladwin,42,16,26
26053,MI,Gogebic,24,16,8
26055,MI,Grand Traverse,124,69,55
26057,MI,Gratiot,42,26,16
26059,MI,Hillsdale,40,22,18
26061,MI,Houghton,28,19,9
26063,MI,Huron,36,20,16
26069,MI,Iosco,22,5,17
26071,MI,Iron,19,10,9
26073,MI,Isabella,48,19,29
26079,MI,Kalkaska,34,16,18
26083,MI,Keweenaw,6,6,0
26085,MI,Lake,36,15,21
26089,MI,Leelanau,21,20,1
26091,MI,Lenawee,106,42,64
26095,MI,Luce,6,5,1
26097,MI,Mackinac,28,12,16
26101,MI,Manistee,37,17,20
26103,MI,Marquette,64,24,40
26105,MI,Mason,40,20,20
26107,MI,Mecosta,49,20,29
26109,MI,Menominee,15,15,0
26113,MI,Missaukee,26,13,13
26119,MI,Montmorency,13,13,0
26123,MI,Newaygo,63,27,36
26127,MI,Oceana,35,21,14
26129,MI,Ogemaw,34,15,19
26131,MI,Ontonagon,10,6,4
26133,MI,Osceola,42,17,25
26135,MI,Oscoda,17,12,5
26137,MI,Otsego,28,10,18
26141,MI,Presque Isle,13,13,0
26143,MI,Roscommon,41,26,15
26151,MI,Sanilac,57,27,30
26153,MI,Schoolcraft,10,3,7
26149,MI,St. Joseph,60,26,34
26157,MI,Tuscola,44,20,24
26159,MI,Van Buren,110,65,45
26165,MI,Wexford,53,24,29
27003,MN,Anoka,272,133,139
27009,MN,Benton,70,25,45
27013,MN,Blue Earth,89,34,55
27017,MN,Carlton,54,25,29
27019,MN,Carver,145,71,74
27025,MN,Chisago,99,44,55
27027,MN,Clay,95,34,61
27037,MN,Dakota,197,83,114
27039,MN,Dodge,38,24,14
27045,MN,Fillmore,31,20,11
27053,MN,Hennepin,830,326,504
27055,MN,Houston,31,13,18
27059,MN,Isanti,62,23,39
27075,MN,Lake,30,17,13
27079,MN,Le Sueur,47,21,26
27095,MN,Mille Lacs,80,36,44
27103,MN,Nicollet,42,16,26
27109,MN,Olmsted,179,72,107
27119,MN,Polk,52,32,20
27123,MN,Ramsey,459,248,211
27139,MN,Scott,140,45,95
27141,MN,Sherburne,295,81,214
27145,MN,Stearns,207,71,136
27137,MN,St. Louis,255,108,147
27157,MN,Wabasha,49,18,31
27163,MN,Washington,249,116,133
27171,MN,Wright,264,146,118
27001,MN,Aitkin,50,18,32
27005,MN,Becker,61,22,39
27007,MN,Beltrami,81,28,53
27011,MN,Big Stone,7,5,2
27015,MN,Brown,37,12,25
27021,MN,Cass,74,42,32
27023,MN,Chippewa,20,10,10
27029,MN,Clearwater,20,10,10
27031,MN,Cook,20,12,8
27033,MN,Cottonwood,21,10,11
27035,MN,Crow Wing,124,41,83
27041,MN,Douglas,85,36,49
27043,MN,Faribault,30,14,16
27047,MN,Freeborn,79,26,53
27049,MN,Goodhue,108,41,67
27051,MN,Grant,15,11,4
27057,MN,Hubbard,48,19,29
27061,MN,Itasca,77,33,44
27063,MN,Jackson,27,14,13
27065,MN,Kanabec,53,21,32
27067,MN,Kandiyohi,109,34,75
27069,MN,Kittson,11,6,5
27071,MN,Koochiching,20,10,10
27073,MN,Lac qui Parle,12,7,5
27077,MN,Lake of the Woods,14,7,7
27081,MN,Lincoln,13,7,6
27083,MN,Lyon,53,18,35
27087,MN,Mahnomen,19,13,6
27089,MN,Marshall,24,16,8
27091,MN,Martin,34,14,20
27085,MN,McLeod,61,25,36
27093,MN,Meeker,49,20,29
27097,MN,Morrison,54,20,34
27099,MN,Mower,77,26,51
27101,MN,Murray,19,12,7
27105,MN,Nobles,36,14,22
27107,MN,Norman,12,7,5
27111,MN,Otter Tail,84,39,45
27113,MN,Pennington,35,10,25
27115,MN,Pine,82,32,50
27117,MN,Pipestone,25,14,11
27121,MN,Pope,14,8,6
27125,MN,Red Lake,11,9,2
27127,MN,Redwood,30,13,17
27129,MN,Renville,37,15,22
27131,MN,Rice,57,31,26
27133,MN,Rock,17,12,5
27135,MN,Roseau,17,9,8
27143,MN,Sibley,29,14,15
27147,MN,Steele,30,24,6
27149,MN,Stevens,15,7,8
27151,MN,Swift,16,9,7
27153,MN,Todd,35,17,18
27155,MN,Traverse,14,6,8
27159,MN,Wadena,22,11,11
27161,MN,Waseca,28,14,14
27165,MN,Watonwan,22,8,14
27167,MN,Wilkin,19,7,12
27169,MN,Winona,63,21,42
27173,MN,Yellow Medicine,26,11,15
28033,MS,DeSoto,274,134,140
28045,MS,Hancock,146,72,74
28047,MS,Harrison,302,118,184
28049,MS,Hinds,338,80,258
28073,MS,Lamar,53,46,7
28089,MS,Madison,85,81,4
28131,MS,Stone,26,22,4
28143,MS,Tunica,100,45,55
28019,MS,Choctaw,14,8,6
28021,MS,Claiborne,29,13,16
28039,MS,George,51,17,34
28041,MS,Greene,22,7,15
28069,MS,Kemper,13,11,2
28075,MS,Lauderdale,127,52,75
28085,MS,Lincoln,52,24,28
28087,MS,Lowndes,108,49,59
28091,MS,Marion,21,15,6
28107,MS,Panola,83,43,40
28115,MS,Pontotoc,40,23,17
28141,MS,Tishomingo,26,12,14
28149,MS,Warren,42,39,3
28151,MS,Washington,50,36,14
29003,MO,Andrew,17,11,6
29013,MO,Bates,63,19,44
29017,MO,Bollinger,17,12,5
29019,MO,Boone,83,66,17
29021,MO,Buchanan,106,69,37
29025,MO,Caldwell,49,10,39
29027,MO,Callaway,33,30,3
29031,MO,Cape Girardeau,82,46,36
29037,MO,Cass,111,90,21
29043,MO,Christian,93,58,35
29047,MO,Clay,196,132,64
29049,MO,Clinton,22,13,9
29051,MO,Cole,79,49,30
29053,MO,Cooper,10,9,1
29059,MO,Dallas,29,15,14
29063,MO,DeKalb,16,10,6
29071,MO,Franklin,150,137,13
29077,MO,Greene,398,141,257
29089,MO,Howard,8,7,1
29095,MO,Jackson,135,96,39
29097,MO,Jasper,124,79,45
29099,MO,Jefferson,225,155,70
29107,MO,Lafayette,48,31,17
29113,MO,Lincoln,95,55,40
29151,MO,Osage,18,11,7
29165,MO,Platte,130,99,31
29167,MO,Polk,40,25,15
29177,MO,Ray,33,16,17
29183,MO,St. Charles,49,34,15
29183,MO,St. Charles,180,143,37
29189,MO,St. Louis,1231,949,282
29219,MO,Warren,58,36,22
29225,MO,Webster,40,19,21
29001,MO,Adair,24,9,15
29005,MO,Atchison,10,5,5
29007,MO,Audrain,43,28,15
29009,MO,Barry,23,21,2
29015,MO,Benton,27,17,10
29023,MO,Butler,43,30,13
29029,MO,Camden,93,54,39
29033,MO,Carroll,9,8,1
29035,MO,Carter,14,8,6
29039,MO,Cedar,38,13,25
29045,MO,Clark,12,5,7
29055,MO,Crawford,41,25,16
29057,MO,Dade,14,9,5
29061,MO,Daviess,7,6,1
29065,MO,Dent,22,17,5
29067,MO,Douglas,13,7,6
29069,MO,Dunklin,24,14,10
29073,MO,Gasconade,16,15,1
29075,MO,Gentry,5,5,0
29079,MO,Grundy,16,6,10
29081,MO,Harrison,11,4,7
29083,MO,Henry,39,25,14
29085,MO,Hickory,13,9,4
29087,MO,Holt,12,6,6
29091,MO,Howell,39,27,12
29093,MO,Iron,16,10,6
29101,MO,Johnson,62,33,29
29103,MO,Knox,2,2,0
29105,MO,Laclede,34,23,11
29109,MO,Lawrence,37,29,8
29111,MO,Lewis,13,7,6
29115,MO,Linn,10,9,1
29117,MO,Livingston,10,10,0
29121,MO,Macon,21,11,10
29123,MO,Madison,10,9,1
29127,MO,Marion,38,16,22
29119,MO,McDonald,29,20,9
29129,MO,Mercer,9,3,6
29131,MO,Miller,24,23,1
29133,MO,Mississippi,27,7,20
29137,MO,Monroe,9,8,1
29139,MO,Montgomery,20,18,2
29141,MO,Morgan,69,37,32
29143,MO,New Madrid,18,16,2
29147,MO,Nodaway,18,15,3
29149,MO,Oregon,10,7,3
29153,MO,Ozark,18,10,8
29155,MO,Pemiscot,49,21,28
29157,MO,Perry,34,22,12
29159,MO,Pettis,28,22,6
29161,MO,Phelps,74,35,39
29163,MO,Pike,23,11,12
29169,MO,Pulaski,40,26,14
29171,MO,Putnam,4,4,0
29173,MO,Ralls,13,12,1
29175,MO,Randolph,40,23,17
29181,MO,Ripley,13,11,2
29195,MO,Saline,26,16,10
29197,MO,Schuyler,9,6,3
29199,MO,Scotland,7,3,4
29203,MO,Shannon,8,3,5
29205,MO,Shelby,8,5,3
29185,MO,St. Clair,66,19,47
29186,MO,Ste. Genevieve,74,47,27
29187,MO,St. Francois,75,61,14
29207,MO,Stoddard,33,16,17
29209,MO,Stone,60,50,10
29211,MO,Sullivan,3,3,0
29213,MO,Taney,59,42,17
29215,MO,Texas,12,12,0
29217,MO,Vernon,46,17,29
29221,MO,Washington,36,21,15
29223,MO,Wayne,26,9,17
29227,MO,Worth,4,3,1
29229,MO,Wright,14,9,5
30009,MT,Carbon,18,11,7
30013,MT,Cascade,140,39,101
30063,MT,Missoula,72,58,14
30095,MT,Stillwater,20,11,9
30111,MT,Yellowstone,182,56,126
30001,MT,Beaverhead,14,8,6
30003,MT,Big Horn,33,17,16
30005,MT,Blaine,13,7,6
30007,MT,Broadwater,25,10,15
,MT,Butte-Silver Bow,97,52,45
30011,MT,Carter,5,4,1
30015,MT,Chouteau,22,9,13
30017,MT,Custer,18,7,11
30019,MT,Daniels,6,3,3
30021,MT,Dawson,39,8,31
30023,MT,Deer Lodge,21,21,0
30025,MT,Fallon,5,4,1
30027,MT,Fergus,20,9,11
30029,MT,Flathead,109,56,53
30031,MT,Gallatin,136,55,81
30033,MT,Garfield,4,3,1
30035,MT,Glacier,25,12,13
30037,MT,Golden Valley,2,2,0
30039,MT,Granite,14,7,7
30041,MT,Hill,30,13,17
30043,MT,Jefferson,28,14,14
30045,MT,Judith Basin,6,5,1
30047,MT,Lake,45,23,22
30049,MT,Lewis and Clark,107,48,59
30051,MT,Liberty,6,6,0
30053,MT,Lincoln,40,20,20
30057,MT,Madison,12,11,1
30055,MT,McCone,4,4,0
30059,MT,Meagher,9,4,5
30061,MT,Mineral,12,6,6
30065,MT,Musselshell,7,7,0
30067,MT,Park,25,15,10
30069,MT,Petroleum,2,2,0
30071,MT,Phillips,10,6,4
30073,MT,Pondera,13,7,6
30075,MT,Powder River,8,4,4
30077,MT,Powell,10,5,5
30079,MT,Prairie,4,3,1
30081,MT,Ravalli,74,32,42
30083,MT,Richland,32,10,22
30085,MT,Roosevelt,42,15,27
30087,MT,Rosebud,24,11,13
30089,MT,Sanders,11,11,0
30091,MT,Sheridan,10,8,2
30097,MT,Sweet Grass,13,7,6
30099,MT,Teton,13,10,3
30101,MT,Toole,21,13,8
30103,MT,Treasure,2,2,0
30105,MT,Valley,19,9,10
30107,MT,Wheatland,11,5,6
30109,MT,Wibaux,3,3,0
31025,NE,Cass,41,26,15
31043,NE,Dakota,19,17,2
31051,NE,Dixon,14,8,6
31055,NE,Douglas,210,132,78
31079,NE,Hall,40,30,10
31093,NE,Howard,12,5,7
31109,NE,Lancaster,109,89,20
31121,NE,Merrick,16,9,7
31153,NE,Sarpy,220,115,105
31155,NE,Saunders,25,13,12
31159,NE,Seward,18,16,2
31177,NE,Washington,52,31,21
31001,NE,Adams,21,18,3
31003,NE,Antelope,19,5,14
31011,NE,Boone,14,5,9
31013,NE,Box Butte,7,6,1
31017,NE,Brown,8,5,3
31019,NE,Buffalo,47,29,18
31021,NE,Burt,10,5,5
31023,NE,Butler,21,11,10
31027,NE,Cedar,7,7,0
31029,NE,Chase,8,4,4
31031,NE,Cherry,5,4,1
31033,NE,Cheyenne,20,10,10
31035,NE,Clay,11,7,4
31037,NE,Colfax,18,10,8
31039,NE,Cuming,6,5,1
31041,NE,Custer,9,8,1
31045,NE,Dawes,17,7,10
31047,NE,Dawson,66,24,42
31049,NE,Deuel,7,6,1
31053,NE,Dodge,26,23,3
31057,NE,Dundy,8,4,4
31059,NE,Fillmore,14,7,7
31061,NE,Franklin,8,4,4
31063,NE,Frontier,9,5,4
31065,NE,Furnas,12,6,6
31067,NE,Gage,18,15,3
31069,NE,Garden,13,5,8
31071,NE,Garfield,2,2,0
31073,NE,Gosper,6,5,1
31075,NE,Grant,2,2,0
31077,NE,Greeley,3,2,1
31081,NE,Hamilton,22,9,13
31083,NE,Harlan,8,4,4
31085,NE,Hayes,1,1,0
31087,NE,Hitchcock,8,5,3
31089,NE,Holt,8,6,2
31091,NE,Hooker,1,1,0
31095,NE,Jefferson,27,17,10
31097,NE,Johnson,13,7,6
31099,NE,Kearney,11,6,5
31101,NE,Keith,17,9,8
31103,NE,Keya Paha,1,1,0
31105,NE,Kimball,9,4,5
31107,NE,Knox,14,4,10
31111,NE,Lincoln,68,24,44
31113,NE,Logan,1,1,0
31119,NE,Madison,62,33,29
31123,NE,Morrill,14,9,5
31125,NE,Nance,7,6,1
31127,NE,Nemaha,11,11,0
31129,NE,Nuckolls,8,3,5
31131,NE,Otoe,31,16,15
31133,NE,Pawnee,5,4,1
31135,NE,Perkins,7,5,2
31137,NE,Phelps,28,7,21
31141,NE,Platte,65,22,43
31145,NE,Red Willow,21,5,16
31147,NE,Richardson,28,9,19
31149,NE,Rock,7,3,4
31151,NE,Saline,18,18,0
31157,NE,Scotts Bluff,24,17,7
31161,NE,Sheridan,17,7,10
31163,NE,Sherman,6,5,1
31167,NE,Stanton,9,8,1
31169,NE,Thayer,14,8,6
31173,NE,Thurston,14,7,7
31175,NE,Valley,9,4,5
31179,NE,Wayne,6,6,0
31181,NE,Webster,10,6,4
31183,NE,Wheeler,2,2,0
31185,NE,York,23,12,11
32510,NV,Carson City,144,100,44
32029,NV,Storey,29,27,2
32001,NV,Churchill,46,38,8
32005,NV,Douglas,124,108,16
32007,NV,Elko,75,62,13
32009,NV,Esmeralda,12,8,4
32013,NV,Humboldt,56,35,21
32015,NV,Lander,31,16,15
32019,NV,Lyon,117,82,35
32021,NV,Mineral,24,18,6
32023,NV,Nye,147,110,37
32027,NV,Pershing,20,13,7
33015,NH,Rockingham,46,25,21
33017,NH,Strafford,40,28,12
33003,NH,Carroll,27,13,14
33005,NH,Cheshire,22,9,13
33009,NH,Grafton,25,10,15
33013,NH,Merrimack,29,16,13
34001,NJ,Atlantic,131,106,25
34003,NJ,Bergen,581,496,85
34005,NJ,Burlington,88,71,17
34007,NJ,Camden,201,171,30
34009,NJ,Cape May,163,136,27
34011,NJ,Cumberland,63,63,0
34013,NJ,Essex,439,367,72
34015,NJ,Gloucester,105,95,10
34017,NJ,Hudson,409,279,130
34019,NJ,Hunterdon,43,38,5
34021,NJ,Mercer,191,147,44
34023,NJ,Middlesex,233,189,44
34025,NJ,Monmouth,612,435,177
34027,NJ,Morris,121,91,30
34029,NJ,Ocean,278,157,121
34031,NJ,Passaic,677,540,137
34033,NJ,Salem,224,190,34
34035,NJ,Somerset,210,177,33
34037,NJ,Sussex,141,119,22
34039,NJ,Union,260,213,47
34041,NJ,Warren,24,20,4
35007,NM,Colfax,14,12,2
35027,NM,Lincoln,37,25,12
35031,NM,McKinley,43,34,9
35047,NM,San Miguel,11,8,3
35051,NM,Sierra,16,14,2
36001,NY,Albany,209,146,63
36007,NY,Broome,59,50,9
36015,NY,Chemung,48,43,5
36027,NY,Dutchess,127,105,22
36043,NY,Herkimer,16,6,10
36045,NY,Jefferson,58,44,14
36051,NY,Livingston,75,49,26
36053,NY,Madison,52,40,12
36055,NY,Monroe,330,277,53
36059,NY,Nassau,3278,"2,357",921
36063,NY,Niagara,162,109,53
36065,NY,Oneida,141,102,39
36067,NY,Onondaga,255,212,43
36069,NY,Ontario,128,71,57
36073,NY,Orleans,41,27,14
36079,NY,Putnam,108,87,21
36083,NY,Rensselaer,43,37,6
36095,NY,Schoharie,35,20,15
36103,NY,Suffolk,395,271,124
36103,NY,Suffolk,3052,"2,518",534
36109,NY,Tompkins,44,40,4
36111,NY,Ulster,83,60,23
36115,NY,Washington,45,40,5
36117,NY,Wayne,80,72,8
36119,NY,Westchester,361,293,68
36123,NY,Yates,30,26,4
36009,NY,Cattaraugus,76,50,26
36011,NY,Cayuga,36,29,7
36013,NY,Chautauqua,114,71,43
36017,NY,Chenango,22,22,0
36019,NY,Clinton,39,26,13
36021,NY,Columbia,75,59,16
36023,NY,Cortland,36,33,3
36025,NY,Delaware,22,18,4
36031,NY,Essex,17,16,1
36033,NY,Franklin,7,5,2
36035,NY,Fulton,32,28,4
36039,NY,Greene,34,32,2
36041,NY,Hamilton,8,7,1
36057,NY,Montgomery,48,27,21
36077,NY,Otsego,22,20,2
36097,NY,Schuyler,21,18,3
36101,NY,Steuben,48,35,13
36089,NY,St. Lawrence,33,31,2
36105,NY,Sullivan,57,57,0
36121,NY,Wyoming,31,31,0
37001,NC,Alamance,296,136,160
37003,NC,Alexander,81,41,40
37007,NC,Anson,61,33,28
37019,NC,Brunswick,302,179,123
37021,NC,Buncombe,385,234,151
37023,NC,Burke,125,93,32
37025,NC,Cabarrus,337,202,135
37027,NC,Caldwell,92,83,9
37029,NC,Camden,20,17,3
37035,NC,Catawba,203,144,59
37037,NC,Chatham,138,100,38
37049,NC,Craven,86,79,7
37051,NC,Cumberland,541,281,260
37053,NC,Currituck,98,62,36
37057,NC,Davidson,177,123,54
37059,NC,Davie,96,60,36
37063,NC,Durham,459,190,269
37065,NC,Edgecombe,127,53,74
37067,NC,Forsyth,561,220,341
37069,NC,Franklin,120,84,36
37071,NC,Gaston,216,116,100
37071,NC,Gaston,226,128,98
37073,NC,Gates,15,14,1
37077,NC,Granville,114,57,57
37081,NC,Guilford,572,232,340
37085,NC,Harnett,254,155,99
37087,NC,Haywood,126,65,61
37089,NC,Henderson,231,155,76
37093,NC,Hoke,122,69,53
37097,NC,Iredell,258,182,76
37101,NC,Johnston,193,126,67
37103,NC,Jones,28,18,10
37109,NC,Lincoln,175,120,55
37115,NC,Madison,48,19,29
37119,NC,Mecklenburg,1083,282,801
37127,NC,Nash,132,84,48
37129,NC,New Hanover,547,377,170
37133,NC,Onslow,267,137,130
37135,NC,Orange,152,97,55
37137,NC,Pamlico,49,22,27
37141,NC,Pender,116,70,46
37145,NC,Person,88,51,37
37147,NC,Pitt,307,120,187
37151,NC,Randolph,244,184,60
37157,NC,Rockingham,144,96,48
37159,NC,Rowan,195,124,71
37169,NC,Stokes,78,52,26
37179,NC,Union,311,219,92
37183,NC,Wake,921,368,553
37191,NC,Wayne,135,128,7
37197,NC,Yadkin,76,40,36
37005,NC,Alleghany,41,24,17
37009,NC,Ashe,75,32,43
37011,NC,Avery,52,28,24
37013,NC,Beaufort,96,56,40
37015,NC,Bertie,43,26,17
37017,NC,Bladen,97,53,44
37031,NC,Carteret,100,67,33
37033,NC,Caswell,52,36,16
37039,NC,Cherokee,74,31,43
37041,NC,Chowan,28,18,10
37043,NC,Clay,37,17,20
37045,NC,Cleveland,182,98,84
37047,NC,Columbus,123,83,40
37055,NC,Dare,147,68,79
37061,NC,Duplin,91,62,29
37075,NC,Graham,35,18,17
37079,NC,Greene,30,22,8
37083,NC,Halifax,102,71,31
37091,NC,Hertford,56,24,32
37095,NC,Hyde,15,13,2
37099,NC,Jackson,79,55,24
37105,NC,Lee,84,40,44
37107,NC,Lenoir,106,61,45
37113,NC,Macon,79,57,22
37117,NC,Martin,42,38,4
37111,NC,McDowell,69,50,19
37121,NC,Mitchell,20,19,1
37123,NC,Montgomery,57,31,26
37125,NC,Moore,159,80,79
37131,NC,Northampton,55,31,24
37139,NC,Pasquotank,52,46,6
37143,NC,Perquimans,19,17,2
37149,NC,Polk,60,33,27
37153,NC,Richmond,88,57,31
37155,NC,Robeson,146,131,15
37161,NC,Rutherford,131,75,56
37163,NC,Sampson,134,93,41
37165,NC,Scotland,65,41,24
37167,NC,Stanly,96,53,43
37171,NC,Surry,134,83,51
37173,NC,Swain,48,28,20
37175,NC,Transylvania,84,58,26
37177,NC,Tyrrell,14,12,2
37181,NC,Vance,88,40,48
37185,NC,Warren,49,33,16
37187,NC,Washington,18,17,1
37189,NC,Watauga,82,49,33
37193,NC,Wilkes,136,76,60
37195,NC,Wilson,153,92,61
37199,NC,Yancey,43,23,20
38015,ND,Burleigh,136,52,84
38017,ND,Cass,167,110,57
38035,ND,Grand Forks,40,34,6
38059,ND,Morton,44,36,8
38065,ND,Oliver,5,4,1
38001,ND,Adams,6,5,1
38003,ND,Barnes,9,8,1
38005,ND,Benson,4,4,0
38007,ND,Billings,6,6,0
38009,ND,Bottineau,21,11,10
38011,ND,Bowman,5,4,1
38013,ND,Burke,7,6,1
38019,ND,Cavalier,12,6,6
38021,ND,Dickey,5,4,1
38023,ND,Divide,7,6,1
38025,ND,Dunn,18,16,2
38027,ND,Eddy,6,5,1
38029,ND,Emmons,6,5,1
38031,ND,Foster,4,3,1
38033,ND,Golden Valley,4,3,1
38037,ND,Grant,5,5,0
38039,ND,Griggs,2,2,0
38041,ND,Hettinger,7,6,1
38043,ND,Kidder,4,3,1
38045,ND,LaMoure ,5,4,1
38047,ND,Logan,3,3,0
38049,ND,McHenry,8,8,0
38051,ND,McIntosh,3,3,0
38053,ND,McKenzie,44,29,15
38055,ND,McLean,41,26,15
38057,ND,Mercer,30,16,14
38061,ND,Mountrail,22,9,13
38063,ND,Nelson,6,5,1
38067,ND,Pembina,20,12,8
38069,ND,Pierce,38,4,34
38071,ND,Ramsey,9,8,1
38073,ND,Ransom,7,5,2
38075,ND,Renville,7,6,1
38077,ND,Richland,38,18,20
38079,ND,Rolette,22,8,14
38081,ND,Sargent,5,4,1
38083,ND,Sheridan,3,3,0
38085,ND,Sioux,1,1,0
38087,ND,Slope,1,1,0
38089,ND,Stark,29,24,5
38091,ND,Steele,3,3,0
38093,ND,Stutsman,15,13,2
38095,ND,Towner,7,6,1
38097,ND,Traill,15,10,5
38099,ND,Walsh,15,10,5
38101,ND,Ward,106,45,61
38103,ND,Wells,5,4,1
38105,ND,Williams,83,38,45
39003,OH,Allen,147,65,82
39015,OH,Brown,49,29,20
39019,OH,Carroll,44,27,17
39041,OH,Delaware,230,107,123
39045,OH,Fairfield,150,110,40
39051,OH,Fulton,23,21,2
39055,OH,Geauga,117,49,68
39057,OH,Greene,161,68,93
39089,OH,Licking,229,96,133
39097,OH,Madison,43,29,14
39109,OH,Miami,119,57,62
39117,OH,Morrow,60,33,27
39129,OH,Pickaway,83,39,44
39133,OH,Portage,153,82,71
39139,OH,Richland,134,52,82
39151,OH,Stark,262,128,134
39153,OH,Summit,399,326,73
39159,OH,Union,67,48,19
39165,OH,Warren,193,102,91
39173,OH,Wood,125,56,69
39005,OH,Ashland,87,49,38
39007,OH,Ashtabula,79,34,45
39009,OH,Athens,36,31,5
39021,OH,Champaign,30,26,4
39027,OH,Clinton,70,35,35
39047,OH,Fayette,41,23,18
39059,OH,Guernsey,59,28,31
39063,OH,Hancock,97,41,56
39083,OH,Knox,73,49,24
39101,OH,Marion,59,33,26
39107,OH,Mercer,67,30,37
39115,OH,Morgan,17,10,7
39121,OH,Noble,29,12,17
39167,OH,Washington,92,49,43
39175,OH,Wyandot,31,15,16
40017,OK,Canadian,110,67,43
40027,OK,Cleveland,230,68,162
40031,OK,Comanche,41,30,11
40033,OK,Cotton,14,5,9
40037,OK,Creek,77,34,43
40047,OK,Garfield,32,24,8
40051,OK,Grady,34,22,12
40081,OK,Lincoln,35,19,16
40083,OK,Logan,68,38,30
40087,OK,McClain,40,26,14
40109,OK,Oklahoma,591,399,192
40111,OK,Okmulgee,17,15,2
40113,OK,Osage,75,37,38
40117,OK,Pawnee,25,11,14
40131,OK,Rogers,43,38,5
40135,OK,Sequoyah,46,23,23
40143,OK,Tulsa,582,221,361
40145,OK,Wagoner,77,37,40
40001,OK,Adair,27,6,21
40003,OK,Alfalfa,12,7,5
40005,OK,Atoka,17,8,9
40007,OK,Beaver,13,7,6
40009,OK,Beckham,41,14,27
40011,OK,Blaine,20,11,9
40013,OK,Bryan,18,15,3
40015,OK,Caddo,35,15,20
40019,OK,Carter,57,20,37
40021,OK,Cherokee,29,23,6
40023,OK,Choctaw,15,6,9
40025,OK,Cimarron,7,3,4
40029,OK,Coal,14,10,4
40035,OK,Craig,31,16,15
40039,OK,Custer,44,19,25
40041,OK,Delaware,46,19,27
40043,OK,Dewey,16,7,9
40045,OK,Ellis,18,8,10
40049,OK,Garvin,30,20,10
40053,OK,Grant,11,6,5
40055,OK,Greer,6,2,4
40057,OK,Harmon,4,3,1
40059,OK,Harper,7,4,3
40061,OK,Haskell,20,8,12
40063,OK,Hughes,27,13,14
40065,OK,Jackson,39,14,25
40067,OK,Jefferson,13,3,10
40069,OK,Johnston,25,7,18
40071,OK,Kay,26,18,8
40073,OK,Kingfisher,22,11,11
40075,OK,Kiowa,10,4,6
40077,OK,Latimer,16,8,8
40079,OK,Le Flore,21,17,4
40085,OK,Love,22,12,10
40093,OK,Major,19,8,11
40095,OK,Marshall,28,7,21
40097,OK,Mayes,55,27,28
40089,OK,McCurtain,26,22,4
40091,OK,McIntosh,13,12,1
40099,OK,Murray,13,6,7
40101,OK,Muskogee,82,27,55
40103,OK,Noble,21,9,12
40105,OK,Nowata,17,7,10
40107,OK,Okfuskee,20,7,13
40115,OK,Ottawa,26,9,17
40119,OK,Payne,95,40,55
40121,OK,Pittsburg,35,23,12
40123,OK,Pontotoc,18,16,2
40125,OK,Pottawatomie,30,25,5
40127,OK,Pushmataha,16,14,2
40129,OK,Roger Mills,13,8,5
40133,OK,Seminole,33,14,19
40137,OK,Stephens,26,22,4
40139,OK,Texas,30,13,17
40141,OK,Tillman,3,3,0
40147,OK,Washington,59,29,30
40149,OK,Washita,28,6,22
40151,OK,Woods,8,7,1
40153,OK,Woodward,35,12,23
41003,OR,Benton,81,67,14
41005,OR,Clackamas,451,206,245
41009,OR,Columbia,57,44,13
41017,OR,Deschutes,253,186,67
41029,OR,Jackson,148,113,35
41033,OR,Josephine,85,63,22
41039,OR,Lane,289,61,228
41043,OR,Linn,179,79,100
41047,OR,Marion,318,94,224
41051,OR,Multnomah,775,131,644
41053,OR,Polk,36,27,9
41067,OR,Washington,595,262,333
41071,OR,Yamhill,85,42,43
41001,OR,Baker,43,31,12
41007,OR,Clatsop,75,26,49
41011,OR,Coos,89,60,29
41013,OR,Crook,32,13,19
41015,OR,Curry,38,16,22
41019,OR,Douglas,135,64,71
41021,OR,Gilliam,7,6,1
41023,OR,Grant,18,18,0
41025,OR,Harney,22,17,5
41027,OR,Hood River,47,20,27
41031,OR,Jefferson,43,17,26
41035,OR,Klamath,91,27,64
41037,OR,Lake,21,20,1
41041,OR,Lincoln,91,30,61
41045,OR,Malheur,63,40,23
41049,OR,Morrow,40,28,12
41055,OR,Sherman,7,6,1
41057,OR,Tillamook,53,45,8
41059,OR,Umatilla,87,25,62
41061,OR,Union,34,16,18
41063,OR,Wallowa,13,5,8
41065,OR,Wasco,31,16,15
41069,OR,Wheeler,5,4,1
42001,PA,Adams,18,14,4
42003,PA,Allegheny,196,164,32
42003,PA,Allegheny,237,220,17
42007,PA,Beaver,24,20,4
42011,PA,Berks,103,91,12
42013,PA,Blair,27,25,2
42017,PA,Bucks,80,65,15
42019,PA,Butler,31,28,3
42027,PA,Centre,29,25,4
42029,PA,Chester,90,72,18
42049,PA,Erie,48,41,7
42055,PA,Franklin,41,22,19
42071,PA,Lancaster,55,48,7
42081,PA,Lycoming,22,16,6
42085,PA,Mercer,18,14,4
42089,PA,Monroe,50,24,26
42091,PA,Montgomery,125,100,25
42103,PA,Pike,26,22,4
42125,PA,Washington,32,29,3
42129,PA,Westmoreland,63,56,7
42131,PA,Wyoming,6,4,2
42133,PA,York,115,105,10
42009,PA,Bedford,11,9,2
42015,PA,Bradford,12,10,2
42031,PA,Clarion,11,8,3
42047,PA,Elk,6,5,1
42059,PA,Greene,15,8,7
42063,PA,Indiana,23,20,3
42065,PA,Jefferson,8,7,1
42067,PA,Juniata,6,5,1
42073,PA,Lawrence,23,18,5
42097,PA,Northumberland,11,9,2
42107,PA,Schuylkill,19,16,3
42109,PA,Snyder,7,7,0
42117,PA,Tioga,10,8,2
42119,PA,Union,8,7,1
42127,PA,Wayne,15,12,3
45003,SC,Aiken,242,132,110
45007,SC,Anderson,313,169,144
45013,SC,Beaufort,309,213,96
45015,SC,Berkeley,184,151,33
45017,SC,Calhoun,40,25,15
45019,SC,Charleston,720,287,433
45023,SC,Chester,102,49,53
45031,SC,Darlington,72,59,13
45035,SC,Dorchester,273,147,126
45039,SC,Fairfield,55,51,4
45041,SC,Florence,254,215,39
45045,SC,Greenville,550,451,99
45051,SC,Horry,81,58,23
45051,SC,Horry,287,266,21
45055,SC,Kershaw,77,66,11
45057,SC,Lancaster,140,119,21
45059,SC,Laurens,108,70,38
45063,SC,Lexington,439,292,147
45077,SC,Pickens,179,149,30
45079,SC,Richland,645,536,109
45081,SC,Saluda,62,24,38
45083,SC,Spartanburg,346,317,29
45085,SC,Sumter,201,107,94
45091,SC,York,209,174,35
45001,SC,Abbeville,656,333,323
45005,SC,Allendale,14,12,2
45009,SC,Bamberg,14,13,1
45011,SC,Barnwell,89,34,55
45021,SC,Cherokee,112,60,52
45025,SC,Chesterfield,61,52,9
45043,SC,Georgetown,146,76,70
45047,SC,Greenwood,144,68,76
45049,SC,Hampton,46,30,16
45067,SC,Marion,72,38,34
45065,SC,McCormick,39,18,21
45071,SC,Newberry,103,47,56
45073,SC,Oconee,183,105,78
45075,SC,Orangeburg,123,80,43
45087,SC,Union,49,31,18
45089,SC,Williamsburg,76,35,41
46083,SD,Lincoln,24,20,4
46087,SD,McCook,9,8,1
46093,SD,Meade,50,18,32
46099,SD,Minnehaha,233,95,138
46103,SD,Pennington,421,101,320
46125,SD,Turner,10,8,2
46127,SD,Union,28,18,10
46003,SD,Aurora,4,3,1
46005,SD,Beadle,26,5,21
46007,SD,Bennett,4,3,1
46009,SD,Bon Homme,3,3,0
46011,SD,Brookings,25,15,10
46013,SD,Brown,62,20,42
46017,SD,Buffalo,1,1,0
46019,SD,Butte,16,5,11
46021,SD,Campbell,2,2,0
46023,SD,Charles Mix,22,7,15
46025,SD,Clark,3,3,0
46027,SD,Clay,15,8,7
46029,SD,Codington,13,10,3
46031,SD,Corson,4,4,0
46033,SD,Custer,13,12,1
46035,SD,Davison,9,7,2
46037,SD,Day,9,4,5
46039,SD,Deuel,6,5,1
46041,SD,Dewey,3,3,0
46043,SD,Douglas,4,4,0
46045,SD,Edmunds,4,4,0
46047,SD,Fall River,19,7,12
46049,SD,Faulk,17,5,12
46051,SD,Grant,9,5,4
46053,SD,Gregory,5,4,1
46055,SD,Haakon,2,2,0
46057,SD,Hamlin,6,6,0
46059,SD,Hand,4,3,1
46061,SD,Hanson,3,3,0
46063,SD,Harding,3,2,1
46065,SD,Hughes,58,6,52
46067,SD,Hutchinson,3,3,0
46069,SD,Hyde,1,1,0
46071,SD,Jackson,3,2,1
46073,SD,Jerauld,4,4,0
46075,SD,Jones,2,2,0
46077,SD,Kingsbury,6,5,1
46079,SD,Lake,15,8,7
46081,SD,Lawrence,40,17,23
46085,SD,Lyman,5,4,1
46091,SD,Marshall,11,6,5
46089,SD,McPherson,4,4,0
46095,SD,Mellette,4,4,0
46097,SD,Miner,4,3,1
46101,SD,Moody,10,6,4
,SD,Oglala Lakota,1,1,0
46105,SD,Perkins,8,7,1
46107,SD,Potter,3,2,1
46109,SD,Roberts,35,6,29
46111,SD,Sanborn,3,3,0
46115,SD,Spink,14,9,5
46117,SD,Stanley,6,5,1
46119,SD,Sully,3,3,0
46123,SD,Tripp,3,2,1
46129,SD,Walworth,13,4,9
46135,SD,Yankton,35,12,23
46137,SD,Ziebach,3,3,0
47001,TN,Anderson,174,64,110
47009,TN,Blount,307,173,134
47011,TN,Bradley,220,110,110
47013,TN,Campbell,87,43,44
47015,TN,Cannon,34,12,22
47019,TN,Carter,134,72,62
47021,TN,Cheatham,90,48,42
47023,TN,Chester,49,16,33
47033,TN,Crockett,39,16,23
47043,TN,Dickson,139,63,76
47047,TN,Fayette,93,45,48
47053,TN,Gibson,81,31,50
47057,TN,Grainger,43,26,17
47063,TN,Hamblen,104,43,61
47065,TN,Hamilton,400,173,227
47169,TN,Trousdale,47,23,24
47073,TN,Hawkins,118,72,46
47089,TN,Jefferson,103,52,51
47093,TN,Knox,1015,430,585
47105,TN,Loudon,106,57,49
47111,TN,Macon,60,32,28
47113,TN,Madison,282,122,160
47115,TN,Marion,72,34,38
47119,TN,Maury,162,82,80
47125,TN,Montgomery,392,138,254
47129,TN,Morgan,50,25,25
47139,TN,Polk,64,27,37
47145,TN,Roane,79,42,37
47147,TN,Robertson,166,72,94
47149,TN,Rutherford,474,239,235
47153,TN,Sequatchie,49,22,27
47157,TN,Shelby,1850,638,"1,212"
47159,TN,Smith,57,28,29
47161,TN,Stewart,55,22,33
47163,TN,Sullivan,318,148,170
47165,TN,Sumner,290,116,174
47167,TN,Tipton,108,63,45
47171,TN,Unicoi,45,26,19
47173,TN,Union,60,35,25
47179,TN,Washington,206,95,111
47187,TN,Williamson,323,198,125
47189,TN,Wilson,266,134,132
47003,TN,Bedford,104,52,52
47005,TN,Benton,60,21,39
47007,TN,Bledsoe,41,14,27
47017,TN,Carroll,71,28,43
47025,TN,Claiborne,85,44,41
47027,TN,Clay,24,15,9
47029,TN,Cocke,81,40,41
47031,TN,Coffee,117,47,70
47035,TN,Cumberland,114,57,57
47039,TN,Decatur,31,13,18
47041,TN,DeKalb,51,27,24
47045,TN,Dyer,91,38,53
47049,TN,Fentress,50,21,29
47051,TN,Franklin,77,44,33
47055,TN,Giles,71,38,33
47059,TN,Greene,171,74,97
47061,TN,Grundy,40,18,22
47067,TN,Hancock,48,17,31
47069,TN,Hardeman,70,30,40
47071,TN,Hardin,53,25,28
47075,TN,Haywood,47,19,28
47077,TN,Henderson,68,34,34
47079,TN,Henry,69,35,34
47081,TN,Hickman,50,29,21
47083,TN,Houston,27,10,17
47085,TN,Humphreys,48,23,25
47087,TN,Jackson,48,18,30
47091,TN,Johnson,49,18,31
47095,TN,Lake,21,8,13
47097,TN,Lauderdale,59,20,39
47099,TN,Lawrence,90,49,41
47101,TN,Lewis,34,16,18
47103,TN,Lincoln,85,41,44
47117,TN,Marshall,52,27,25
47107,TN,McMinn,88,41,47
47109,TN,McNairy,38,19,19
47121,TN,Meigs,35,15,20
47123,TN,Monroe,83,46,37
47127,TN,Moore,31,17,14
47131,TN,Obion,69,34,35
47133,TN,Overton,57,24,33
47135,TN,Perry,29,16,13
47137,TN,Pickett,17,12,5
47141,TN,Putnam,166,81,85
47143,TN,Rhea,57,55,2
47151,TN,Scott,57,30,27
47155,TN,Sevier,212,104,108
47175,TN,Van Buren,23,7,16
47177,TN,Warren,112,56,56
47181,TN,Wayne,50,16,34
47183,TN,Weakley,43,22,21
47185,TN,White,85,39,46
48011,TX,Armstrong,7,3,4
48013,TX,Atascosa,113,44,69
48015,TX,Austin,55,42,13
48019,TX,Bandera,65,29,36
48021,TX,Bastrop,199,79,120
48029,TX,Bexar,1731,578,"1,153"
48037,TX,Bowie,45,39,6
48039,TX,Brazoria,335,139,196
48041,TX,Brazos,261,103,158
48051,TX,Burleson,43,18,25
48055,TX,Caldwell,101,34,67
48059,TX,Callahan,15,6,9
48061,TX,Cameron,443,105,338
48077,TX,Clay,26,16,10
48085,TX,Collin,513,153,360
48091,TX,Comal,309,151,158
48107,TX,Crosby,15,6,9
48135,TX,Ector,142,91,51
48139,TX,Ellis,229,83,146
48141,TX,El Paso,991,261,730
48157,TX,Fort Bend,786,551,235
48181,TX,Grayson,182,63,119
48183,TX,Gregg,256,105,151
48187,TX,Guadalupe,223,104,119
48199,TX,Hardin,70,34,36
48201,TX,Harris,4768,"2,274","2,494"
48203,TX,Harrison,108,45,63
48209,TX,Hays,359,155,204
48215,TX,Hidalgo,794,282,512
48229,TX,Hudspeth,42,14,28
48231,TX,Hunt,140,48,92
48245,TX,Jefferson,392,104,288
48251,TX,Johnson,125,86,39
48253,TX,Jones,35,9,26
48257,TX,Kaufman,191,77,114
48291,TX,Liberty,95,71,24
48303,TX,Lubbock,494,205,289
48305,TX,Lynn,21,7,14
48309,TX,McLennan,485,140,345
48325,TX,Medina,83,42,41
48339,TX,Montgomery,923,521,402
48355,TX,Nueces,294,47,247
48359,TX,Oldham,12,7,5
48361,TX,Orange,131,61,70
48367,TX,Parker,131,93,38
48375,TX,Potter,202,96,106
48381,TX,Randall,209,91,118
48395,TX,Robertson,35,15,20
48397,TX,Rockwall,124,50,74
48401,TX,Rusk,76,40,36
48423,TX,Smith,382,170,212
48431,TX,Sterling,5,5,0
48439,TX,Tarrant,1412,372,"1,040"
48441,TX,Taylor,230,81,149
48451,TX,Tom Green,174,50,124
48453,TX,Travis,1728,357,"1,371"
48469,TX,Victoria,205,110,95
48479,TX,Webb,319,148,171
48485,TX,Wichita,187,53,134
48491,TX,Williamson,566,219,347
48493,TX,Wilson,82,36,46
48001,TX,Anderson,70,36,34
48005,TX,Angelina,110,47,63
48007,TX,Aransas,69,23,46
48017,TX,Bailey,27,7,20
48023,TX,Baylor,9,4,5
48025,TX,Bee,69,24,45
48031,TX,Blanco,31,15,16
48033,TX,Borden,4,3,1
48035,TX,Bosque,43,19,24
48043,TX,Brewster,36,19,17
48045,TX,Briscoe,3,3,0
48047,TX,Brooks,37,17,20
48049,TX,Brown,70,32,38
48053,TX,Burnet,147,53,94
48057,TX,Calhoun,64,29,35
48063,TX,Camp,20,9,11
48067,TX,Cass,50,21,29
48069,TX,Castro,23,7,16
48073,TX,Cherokee,77,32,45
48079,TX,Cochran,18,9,9
48081,TX,Coke,6,5,1
48087,TX,Collingsworth,9,9,0
48089,TX,Colorado,53,23,30
48097,TX,Cooke,85,35,50
48101,TX,Cottle,1,1,0
48103,TX,Crane,16,9,7
48111,TX,Dallam,6,5,1
48115,TX,Dawson,21,9,12
48117,TX,Deaf Smith,40,13,27
48119,TX,Delta,22,10,12
48123,TX,DeWitt,52,19,33
48125,TX,Dickens,7,3,4
48127,TX,Dimmit,71,32,39
48129,TX,Donley,10,5,5
48131,TX,Duval,38,20,18
48133,TX,Eastland,30,12,18
48143,TX,Erath,66,24,42
48147,TX,Fannin,30,20,10
48151,TX,Fisher,13,4,9
48153,TX,Floyd,10,7,3
48155,TX,Foard,5,4,1
48159,TX,Franklin,27,27,0
48161,TX,Freestone,36,16,20
48163,TX,Frio,36,17,19
48165,TX,Gaines,39,18,21
48169,TX,Garza,43,9,34
48171,TX,Gillespie,54,34,20
48173,TX,Glasscock,5,4,1
48177,TX,Gonzales,57,21,36
48179,TX,Gray,43,14,29
48189,TX,Hale,64,64,0
48191,TX,Hall,10,4,6
48195,TX,Hansford,13,7,6
48197,TX,Hardeman,12,8,4
48205,TX,Hartley,7,6,1
48207,TX,Haskell,12,3,9
48211,TX,Hemphill,17,8,9
48213,TX,Henderson,164,80,84
48217,TX,Hill,75,34,41
48219,TX,Hockley,28,13,15
48221,TX,Hood,138,50,88
48223,TX,Hopkins,66,28,38
48225,TX,Houston,50,21,29
48227,TX,Howard,61,22,39
48233,TX,Hutchinson,35,14,21
48237,TX,Jack,31,15,16
48239,TX,Jackson,35,15,20
48241,TX,Jasper,24,20,4
48243,TX,Jeff Davis,5,4,1
48255,TX,Karnes,62,31,31
48263,TX,Kent,5,2,3
48265,TX,Kerr,111,48,63
48269,TX,King,2,2,0
48271,TX,Kinney,14,7,7
48279,TX,Lamb,28,10,18
48283,TX,La Salle,129,32,97
48285,TX,Lavaca,34,15,19
48287,TX,Lee,40,14,26
48289,TX,Leon,47,26,21
48293,TX,Limestone,76,20,56
48295,TX,Lipscomb,13,6,7
48313,TX,Madison,31,13,18
48315,TX,Marion,22,11,11
48321,TX,Matagorda,75,39,36
48311,TX,McMullen,13,11,2
48331,TX,Milam,68,24,44
48335,TX,Mitchell,18,5,13
48337,TX,Montague,32,13,19
48341,TX,Moore,52,20,32
48343,TX,Morris,24,10,14
48345,TX,Motley,2,2,0
48347,TX,Nacogdoches,83,39,44
48349,TX,Navarro,130,56,74
48353,TX,Nolan,43,16,27
48363,TX,Palo Pinto,57,24,33
48365,TX,Panola,61,35,26
48373,TX,Polk,106,47,59
48379,TX,Rains,35,15,20
48383,TX,Reagan,31,15,16
48385,TX,Real,11,5,6
48387,TX,Red River,31,13,18
48391,TX,Refugio,42,17,25
48393,TX,Roberts,6,5,1
48399,TX,Runnels,30,6,24
48403,TX,Sabine,20,10,10
48405,TX,San Augustine,20,10,10
48407,TX,San Jacinto,65,31,34
48413,TX,Schleicher,12,6,6
48415,TX,Scurry,41,7,34
48419,TX,Shelby,37,17,20
48421,TX,Sherman,13,5,8
48427,TX,Starr,109,45,64
48433,TX,Stonewall,9,3,6
48437,TX,Swisher,11,5,6
48445,TX,Terry,33,12,21
48447,TX,Throckmorton,6,2,4
48449,TX,Titus,59,24,35
48455,TX,Trinity,17,13,4
48463,TX,Uvalde,73,32,41
48465,TX,Val Verde,70,46,24
48467,TX,Van Zandt,82,40,42
48471,TX,Walker,72,35,37
48475,TX,Ward,31,14,17
48477,TX,Washington,64,33,31
48481,TX,Wharton,78,44,34
48483,TX,Wheeler,24,10,14
48487,TX,Wilbarger,18,7,11
48489,TX,Willacy,38,16,22
48495,TX,Winkler,25,25,0
48499,TX,Wood,72,32,40
48501,TX,Yoakum,22,10,12
48503,TX,Young,34,12,22
49003,UT,Box Elder,79,23,56
49005,UT,Cache,138,45,93
49011,UT,Davis,291,181,110
49023,UT,Juab,29,17,12
49029,UT,Morgan,14,12,2
,UT,Salt Lake County Unified,483,376,107
49045,UT,Tooele,114,28,86
49049,UT,Utah,403,163,240
49053,UT,Washington,167,40,127
49001,UT,Beaver,70,22,48
49007,UT,Carbon,48,27,21
49009,UT,Daggett,5,4,1
49013,UT,Duchesne,64,27,37
49015,UT,Emery,40,31,9
49017,UT,Garfield,30,14,16
49021,UT,Iron,79,33,46
49025,UT,Kane,52,21,31
49027,UT,Millard,56,31,25
49031,UT,Piute,4,4,0
49033,UT,Rich,10,4,6
49037,UT,San Juan,32,12,20
49039,UT,Sanpete,64,27,37
49041,UT,Sevier,59,22,37
49043,UT,Summit,105,62,43
49047,UT,Uintah,89,27,62
49051,UT,Wasatch,68,35,33
49055,UT,Wayne,6,5,1
50007,VT,Chittenden,17,15,2
50011,VT,Franklin,17,16,1
50013,VT,Grand Isle,3,3,0
50001,VT,Addison,11,9,2
50003,VT,Bennington,16,13,3
50005,VT,Caledonia,7,6,1
50009,VT,Essex,4,4,0
50015,VT,Lamoille,24,13,11
50017,VT,Orange,8,6,2
50019,VT,Orleans,17,15,2
50021,VT,Rutland,20,15,5
50023,VT,Washington,10,6,4
50025,VT,Windham,19,12,7
50027,VT,Windsor,16,14,2
51003,VA,Albemarle,184,146,38
51007,VA,Amelia,29,18,11
51009,VA,Amherst,46,40,6
51011,VA,Appomattox,24,22,2
51013,VA,Arlington,445,344,101
51015,VA,Augusta,85,74,11
51019,VA,Bedford,93,85,8
51023,VA,Botetourt,124,97,27
51031,VA,Campbell,76,67,9
51036,VA,Charles City,20,13,7
51041,VA,Chesterfield,623,515,108
51043,VA,Clarke,30,19,11
51045,VA,Craig,13,8,5
51047,VA,Culpeper,102,88,14
51053,VA,Dinwiddie,44,40,4
51059,VA,Fairfax,1728,"1,464",264
51061,VA,Fauquier,171,131,40
51065,VA,Fluvanna,47,34,13
51067,VA,Franklin,105,81,24
51069,VA,Frederick,141,131,10
51071,VA,Giles,37,26,11
51073,VA,Gloucester,96,80,16
51075,VA,Goochland,55,39,16
51079,VA,Greene,39,25,14
51085,VA,Hanover,273,254,19
51087,VA,Henrico,826,656,170
51093,VA,Isle of Wight,59,50,9
51095,VA,James City,110,104,6
51097,VA,King and Queen,21,13,8
51101,VA,King William,35,21,14
51107,VA,Loudoun,681,558,123
51113,VA,Madison,29,23,6
51115,VA,Mathews,19,11,8
51121,VA,Montgomery,119,112,7
51125,VA,Nelson,28,23,5
51127,VA,New Kent,46,32,14
51145,VA,Powhatan,46,41,5
51149,VA,Prince George,76,59,17
51153,VA,Prince William,787,648,139
51155,VA,Pulaski,53,51,2
51157,VA,Rappahannock,21,16,5
51161,VA,Roanoke,156,142,14
51165,VA,Rockingham,82,65,17
51169,VA,Scott,37,30,7
51175,VA,Southampton,67,53,14
51177,VA,Spotsylvania,253,200,53
51179,VA,Stafford,251,184,67
51183,VA,Sussex,45,42,3
51187,VA,Warren,75,59,16
51191,VA,Washington,93,74,19
51199,VA,York,82,74,8
51001,VA,Accomack,64,56,8
51005,VA,Alleghany,71,51,20
51017,VA,Bath,22,15,7
51021,VA,Bland,18,12,6
51025,VA,Brunswick,48,34,14
51027,VA,Buchanan,48,35,13
51029,VA,Buckingham,26,19,7
51033,VA,Caroline,72,50,22
51035,VA,Carroll,43,38,5
51037,VA,Charlotte,40,38,2
51049,VA,Cumberland,22,16,6
51051,VA,Dickenson,37,26,11
51057,VA,Essex,16,13,3
51063,VA,Floyd,37,27,10
51077,VA,Grayson,34,27,7
51081,VA,Greensville,36,23,13
51083,VA,Halifax,40,36,4
51089,VA,Henry,132,119,13
51091,VA,Highland,13,8,5
51099,VA,King George,54,38,16
51103,VA,Lancaster,41,32,9
51105,VA,Lee,34,34,0
51109,VA,Louisa,63,46,17
51111,VA,Lunenburg,19,13,6
51117,VA,Mecklenburg,52,50,2
51119,VA,Middlesex,27,19,8
51131,VA,Northampton,85,68,17
51133,VA,Northumberland,35,24,11
51135,VA,Nottoway,25,14,11
51137,VA,Orange,43,40,3
51139,VA,Page,71,55,16
51141,VA,Patrick,71,54,17
51143,VA,Pittsylvania,129,111,18
51147,VA,Prince Edward,33,33,0
51159,VA,Richmond,21,13,8
51163,VA,Rockbridge,41,37,4
51167,VA,Russell,52,36,16
51171,VA,Shenandoah,68,62,6
51173,VA,Smyth,51,44,7
51181,VA,Surry,15,14,1
51185,VA,Tazewell,74,50,24
51193,VA,Westmoreland,43,27,16
51195,VA,Wise,69,53,16
51197,VA,Wythe,44,35,9
53003,WA,Asotin,31,13,18
53005,WA,Benton,86,73,13
53007,WA,Chelan,74,58,16
53011,WA,Clark,230,141,89
53015,WA,Cowlitz,66,42,24
53017,WA,Douglas,37,31,6
53021,WA,Franklin,81,27,54
53033,WA,King,270,214,56
53035,WA,Kitsap,243,122,121
53053,WA,Pierce,355,290,65
53057,WA,Skagit,136,56,80
53059,WA,Skamania,36,33,3
53061,WA,Snohomish,370,297,73
53063,WA,Spokane,151,125,26
53065,WA,Stevens,60,28,32
53067,WA,Thurston,238,93,145
53071,WA,Walla Walla,35,28,7
53073,WA,Whatcom,191,89,102
53077,WA,Yakima,85,57,28
53001,WA,Adams,34,15,19
53009,WA,Clallam,45,37,8
53013,WA,Columbia,9,8,1
53019,WA,Ferry,23,7,16
53023,WA,Garfield,15,8,7
53025,WA,Grant,127,56,71
53027,WA,Grays Harbor,79,62,17
53029,WA,Island,72,39,33
53031,WA,Jefferson,42,22,20
53037,WA,Kittitas,80,33,47
53039,WA,Klickitat,40,21,19
53041,WA,Lewis,109,42,67
53043,WA,Lincoln,28,15,13
53045,WA,Mason,92,48,44
53047,WA,Okanogan,81,30,51
53049,WA,Pacific,43,15,28
53051,WA,Pend Oreille,36,15,21
53055,WA,San Juan,35,20,15
53069,WA,Wahkiakum,20,9,11
53075,WA,Whitman,35,17,18
54003,WV,Berkeley,64,57,7
54005,WV,Boone,22,19,3
54009,WV,Brooke,17,17,0
54011,WV,Cabell,49,43,6
54015,WV,Clay,5,5,0
54019,WV,Fayette,41,34,7
54027,WV,Hampshire,23,18,5
54029,WV,Hancock,35,31,4
54035,WV,Jackson,24,16,8
54037,WV,Jefferson,36,30,6
54039,WV,Kanawha,133,104,29
54043,WV,Lincoln,7,6,1
54051,WV,Marshall,35,32,3
54057,WV,Mineral,19,16,3
54061,WV,Monongalia,45,41,4
54065,WV,Morgan,12,11,1
54069,WV,Ohio,38,36,2
54077,WV,Preston,24,21,3
54079,WV,Putnam,68,42,26
54081,WV,Raleigh,68,53,15
54099,WV,Wayne,25,22,3
54105,WV,Wirt,3,3,0
54107,WV,Wood,61,38,23
54001,WV,Barbour,15,7,8
54007,WV,Braxton,11,9,2
54013,WV,Calhoun,6,4,2
54017,WV,Doddridge,10,9,1
54021,WV,Gilmer,6,4,2
54023,WV,Grant,10,10,0
54025,WV,Greenbrier,38,27,11
54031,WV,Hardy,12,11,1
54033,WV,Harrison,57,53,4
54041,WV,Lewis,14,13,1
54045,WV,Logan,22,20,2
54049,WV,Marion,44,29,15
54053,WV,Mason,26,19,7
54047,WV,McDowell,15,13,2
54055,WV,Mercer,41,29,12
54059,WV,Mingo,18,16,2
54063,WV,Monroe,12,9,3
54067,WV,Nicholas,24,21,3
54071,WV,Pendleton,3,3,0
54073,WV,Pleasants,7,6,1
54075,WV,Pocahontas,9,6,3
54083,WV,Randolph,20,14,6
54085,WV,Ritchie,12,8,4
54087,WV,Roane,10,7,3
54089,WV,Summers,8,7,1
54091,WV,Taylor,12,6,6
54093,WV,Tucker,10,8,2
54095,WV,Tyler,13,11,2
54097,WV,Upshur,14,12,2
54101,WV,Webster,6,3,3
54103,WV,Wetzel,19,13,6
54109,WV,Wyoming,18,18,0
55009,WI,Brown,468,162,306
55015,WI,Calumet,55,28,27
55017,WI,Chippewa,74,44,30
55021,WI,Columbia,107,43,64
55025,WI,Dane,571,464,107
55031,WI,Douglas,73,31,42
55035,WI,Eau Claire,108,42,66
55039,WI,Fond du Lac,124,59,65
55045,WI,Green,55,41,14
55049,WI,Iowa,38,19,19
55059,WI,Kenosha,333,121,212
55061,WI,Kewaunee,36,31,5
55063,WI,La Crosse,108,40,68
55069,WI,Lincoln,61,29,32
55073,WI,Marathon,184,70,114
55079,WI,Milwaukee,805,330,475
55083,WI,Oconto,71,32,39
55087,WI,Outagamie,183,72,111
55089,WI,Ozaukee,103,78,25
55093,WI,Pierce,50,36,14
55101,WI,Racine,261,159,102
55105,WI,Rock,199,92,107
55117,WI,Sheboygan,189,71,118
55109,WI,St. Croix,84,77,7
55131,WI,Washington,168,76,92
55133,WI,Waukesha,327,166,161
55139,WI,Winnebago,199,140,59
55001,WI,Adams,58,28,30
55003,WI,Ashland,51,24,27
55005,WI,Barron,73,29,44
55007,WI,Bayfield,43,20,23
55011,WI,Buffalo,16,13,3
55013,WI,Burnett,36,18,18
55019,WI,Clark,60,28,32
55023,WI,Crawford,30,23,7
55027,WI,Dodge,157,59,98
55029,WI,Door,49,45,4
55033,WI,Dunn,68,38,30
55037,WI,Florence,21,12,9
55041,WI,Forest,43,22,21
55043,WI,Grant,59,30,29
55047,WI,Green Lake,44,19,25
55051,WI,Iron,23,11,12
55053,WI,Jackson,47,21,26
55055,WI,Jefferson,116,93,23
55057,WI,Juneau,98,42,56
55065,WI,Lafayette,30,28,2
55067,WI,Langlade,45,18,27
55071,WI,Manitowoc,99,62,37
55075,WI,Marinette,77,32,45
55077,WI,Marquette,21,20,1
55078,WI,Menominee,16,9,7
55081,WI,Monroe,56,27,29
55085,WI,Oneida,86,37,49
55091,WI,Pepin,19,8,11
55095,WI,Polk,75,29,46
55097,WI,Portage,107,51,56
55099,WI,Price,25,19,6
55103,WI,Richland,32,17,15
55107,WI,Rusk,31,28,3
55111,WI,Sauk,142,47,95
55113,WI,Sawyer,47,26,21
55115,WI,Shawano,109,38,71
55119,WI,Taylor,44,19,25
55121,WI,Trempealeau,57,27,30
55123,WI,Vernon,51,22,29
55125,WI,Vilas,76,39,37
55127,WI,Walworth,194,82,112
55129,WI,Washburn,35,17,18
55135,WI,Waupaca,111,94,17
55137,WI,Waushara,54,25,29
55141,WI,Wood,71,41,30
56021,WY,Laramie,174,51,123
56025,WY,Natrona,149,109,40
56001,WY,Albany,47,44,3
56003,WY,Big Horn,40,15,25
56005,WY,Campbell,151,56,95
56007,WY,Carbon,55,17,38
56009,WY,Converse,44,18,26
56011,WY,Crook,21,14,7
56013,WY,Fremont,93,65,28
56015,WY,Goshen,26,8,18
56017,WY,Hot Springs,13,5,8
56019,WY,Johnson,32,29,3
56023,WY,Lincoln,49,22,27
56027,WY,Niobrara,15,4,11
56029,WY,Park,55,45,10
56031,WY,Platte,37,24,13
56033,WY,Sheridan,58,20,38
56035,WY,Sublette,72,55,17
56037,WY,Sweetwater,86,37,49
56041,WY,Uinta,49,35,14
56043,WY,Washakie,8,7,1
56045,WY,Weston,7,7,0
